{
    "1": 7,
    "2": 7,
    "3": 6,
    "4": 6,
    "5": 6,
    "6": 7,
    "7": 6,
    "8": 6,
    "9": 6,
    "10": 5,
    "11": 4,
    "12": 3,
    "13": 2,
    "14": 6,
    "15": 2,
    "16": 2,
    "17": 5,
    "18": 5,
    "19": 5,
    "20": 5,
    "21": 5,
    "22": 5,
    "23": 1,
    "24": 1,
    "25": 1,
    "26": 1,
    "27": 3,
    "28": 3,
    "29": 3,
    "30": 3,
    "31": 3,
    "32": 3,
    "33": 3,
    "34": 1,
    "35": 1,
    "36": 0,
    "37": 2,
    "38": 1,
    "39": 2,
    "40": 2,
    "41": 2,
    "42": 0,
    "43": 7,
    "44": 2,
    "45": 7,
    "46": 7,
    "47": 7,
    "48": 7,
    "49": 4,
    "50": 4,
    "51": 4,
    "52": 4,
    "53": 4,
    "54": 4,
    "55": 4,
    "56": 0,
    "57": 0,
    "58": 0,
    "59": 0,
    "60": 0
}