{
    "1": 5,
    "2": 5,
    "3": 5,
    "4": 4,
    "5": 4,
    "6": 4,
    "7": 3,
    "8": 3,
    "9": 3,
    "10": 4,
    "11": 4,
    "12": 4,
    "13": 2,
    "14": 2,
    "15": 2,
    "16": 3,
    "17": 3,
    "18": 3,
    "19": 1,
    "20": 1,
    "21": 0,
    "22": 2,
    "23": 2,
    "24": 0,
    "25": 1,
    "26": 1,
    "27": 1,
    "28": 5,
    "29": 5,
    "30": 5,
    "31": 1,
    "32": 1,
    "33": 0,
    "34": 2,
    "35": 2,
    "36": 2,
    "37": 0,
    "38": 0,
    "39": 0,
    "40": 1,
    "41": 1,
    "42": 5,
    "43": 3,
    "44": 3,
    "45": 4,
    "46": 4,
    "47": 4,
    "48": 4,
    "49": 3,
    "50": 3,
    "51": 0,
    "52": 5,
    "53": 5
}