{
    "1": 7,
    "2": 7,
    "3": 7,
    "4": 6,
    "5": 6,
    "6": 6,
    "7": 6,
    "8": 6,
    "9": 6,
    "10": 6,
    "11": 6,
    "12": 6,
    "13": 6,
    "14": 5,
    "15": 6,
    "16": 4,
    "17": 4,
    "18": 5,
    "19": 5,
    "20": 4,
    "21": 5,
    "22": 5,
    "23": 7,
    "24": 5,
    "25": 5,
    "26": 3,
    "27": 3,
    "28": 5,
    "29": 3,
    "30": 4,
    "31": 2,
    "32": 3,
    "33": 7,
    "34": 2,
    "35": 3,
    "36": 7,
    "37": 2,
    "38": 3,
    "39": 1,
    "40": 2,
    "41": 2,
    "42": 1,
    "43": 2,
    "44": 2,
    "45": 4,
    "46": 0,
    "47": 2,
    "48": 0,
    "49": 0,
    "50": 0,
    "51": 0,
    "52": 1,
    "53": 1,
    "54": 1
}