{
    "1": 7,
    "2": 7,
    "3": 7,
    "4": 6,
    "5": 7,
    "6": 7,
    "7": 7,
    "8": 7,
    "9": 5,
    "10": 5,
    "11": 5,
    "12": 5,
    "13": 5,
    "14": 7,
    "15": 5,
    "16": 5,
    "17": 4,
    "18": 4,
    "19": 4,
    "20": 4,
    "21": 4,
    "22": 4,
    "23": 3,
    "24": 3,
    "25": 3,
    "26": 3,
    "27": 2,
    "28": 2,
    "29": 2,
    "30": 2,
    "31": 2,
    "32": 1,
    "33": 1,
    "34": 3,
    "35": 3,
    "36": 1,
    "37": 1,
    "38": 3,
    "39": 1,
    "40": 5,
    "41": 5,
    "42": 5,
    "43": 5,
    "44": 5,
    "45": 5,
    "46": 5,
    "47": 0,
    "48": 0,
    "49": 0,
    "50": 0,
    "51": 0,
    "52": 0,
    "53": 0,
    "54": 0,
    "55": 3,
    "56": 6,
    "57": 6,
    "58": 6,
    "59": 6,
    "60": 6
}