{
    "1": 5,
    "2": 5,
    "3": 5,
    "4": 4,
    "5": 4,
    "6": 4,
    "7": 3,
    "8": 3,
    "9": 3,
    "10": 3,
    "11": 3,
    "12": 3,
    "13": 5,
    "14": 5,
    "15": 5,
    "16": 4,
    "17": 4,
    "18": 4,
    "19": 3,
    "20": 3,
    "21": 2,
    "22": 1,
    "23": 1,
    "24": 2,
    "25": 1,
    "26": 1,
    "27": 2,
    "28": 1,
    "29": 1,
    "30": 2,
    "31": 1,
    "32": 1,
    "33": 0,
    "34": 0,
    "35": 0,
    "36": 0,
    "37": 0,
    "38": 0,
    "39": 0,
    "40": 1,
    "41": 1,
    "42": 4,
    "43": 5,
    "44": 5,
    "45": 5,
    "46": 4,
    "47": 4,
    "48": 4,
    "49": 3,
    "50": 3,
    "51": 2,
    "52": 5,
    "53": 0
}