{
    "1": 7,
    "2": 6,
    "3": 6,
    "4": 5,
    "5": 5,
    "6": 5,
    "7": 5,
    "8": 5,
    "9": 5,
    "10": 5,
    "11": 5,
    "12": 5,
    "13": 6,
    "14": 7,
    "15": 5,
    "16": 5,
    "17": 4,
    "18": 7,
    "19": 7,
    "20": 6,
    "21": 7,
    "22": 7,
    "23": 6,
    "24": 7,
    "25": 7,
    "26": 3,
    "27": 3,
    "28": 7,
    "29": 3,
    "30": 4,
    "31": 2,
    "32": 3,
    "33": 4,
    "34": 2,
    "35": 3,
    "36": 1,
    "37": 2,
    "38": 3,
    "39": 1,
    "40": 2,
    "41": 2,
    "42": 4,
    "43": 2,
    "44": 2,
    "45": 4,
    "46": 0,
    "47": 2,
    "48": 0,
    "49": 0,
    "50": 0,
    "51": 0,
    "52": 1,
    "53": 1,
    "54": 1
}