{
    "1": 7,
    "2": 7,
    "3": 6,
    "4": 6,
    "5": 6,
    "6": 6,
    "7": 6,
    "8": 6,
    "9": 6,
    "10": 6,
    "11": 6,
    "12": 6,
    "13": 6,
    "14": 5,
    "15": 6,
    "16": 5,
    "17": 4,
    "18": 4,
    "19": 4,
    "20": 4,
    "21": 7,
    "22": 4,
    "23": 7,
    "24": 7,
    "25": 7,
    "26": 7,
    "27": 3,
    "28": 3,
    "29": 3,
    "30": 3,
    "31": 3,
    "32": 2,
    "33": 2,
    "34": 7,
    "35": 7,
    "36": 5,
    "37": 5,
    "38": 7,
    "39": 5,
    "40": 6,
    "41": 6,
    "42": 2,
    "43": 2,
    "44": 6,
    "45": 2,
    "46": 2,
    "47": 2,
    "48": 2,
    "49": 2,
    "50": 1,
    "51": 2,
    "52": 1,
    "53": 1,
    "54": 1,
    "55": 1,
    "56": 0,
    "57": 0,
    "58": 0,
    "59": 0,
    "60": 0
}