{
    "1": 7,
    "2": 6,
    "3": 6,
    "4": 7,
    "5": 7,
    "6": 7,
    "7": 7,
    "8": 7,
    "9": 7,
    "10": 7,
    "11": 7,
    "12": 7,
    "13": 5,
    "14": 4,
    "15": 7,
    "16": 4,
    "17": 6,
    "18": 4,
    "19": 4,
    "20": 6,
    "21": 4,
    "22": 4,
    "23": 5,
    "24": 4,
    "25": 4,
    "26": 5,
    "27": 3,
    "28": 4,
    "29": 3,
    "30": 5,
    "31": 2,
    "32": 3,
    "33": 3,
    "34": 2,
    "35": 3,
    "36": 1,
    "37": 2,
    "38": 2,
    "39": 1,
    "40": 2,
    "41": 2,
    "42": 6,
    "43": 2,
    "44": 2,
    "45": 5,
    "46": 0,
    "47": 2,
    "48": 0,
    "49": 0,
    "50": 0,
    "51": 0,
    "52": 1,
    "53": 1,
    "54": 1
}