{
    "1": 7,
    "2": 7,
    "3": 7,
    "4": 7,
    "5": 7,
    "6": 7,
    "7": 7,
    "8": 7,
    "9": 6,
    "10": 5,
    "11": 6,
    "12": 6,
    "13": 6,
    "14": 6,
    "15": 6,
    "16": 6,
    "17": 4,
    "18": 4,
    "19": 4,
    "20": 4,
    "21": 4,
    "22": 4,
    "23": 3,
    "24": 3,
    "25": 3,
    "26": 2,
    "27": 2,
    "28": 2,
    "29": 2,
    "30": 2,
    "31": 2,
    "32": 1,
    "33": 1,
    "34": 3,
    "35": 3,
    "36": 1,
    "37": 1,
    "38": 3,
    "39": 1,
    "40": 6,
    "41": 6,
    "42": 5,
    "43": 5,
    "44": 6,
    "45": 5,
    "46": 5,
    "47": 5,
    "48": 6,
    "49": 6,
    "50": 5,
    "51": 5,
    "52": 5,
    "53": 5,
    "54": 5,
    "55": 5,
    "56": 0,
    "57": 0,
    "58": 0,
    "59": 0,
    "60": 0
}