{
    "1": 7,
    "2": 7,
    "3": 7,
    "4": 6,
    "5": 6,
    "6": 6,
    "7": 6,
    "8": 6,
    "9": 6,
    "10": 6,
    "11": 6,
    "12": 6,
    "13": 5,
    "14": 4,
    "15": 6,
    "16": 3,
    "17": 3,
    "18": 4,
    "19": 4,
    "20": 2,
    "21": 4,
    "22": 4,
    "23": 5,
    "24": 4,
    "25": 4,
    "26": 7,
    "27": 1,
    "28": 4,
    "29": 5,
    "30": 5,
    "31": 1,
    "32": 3,
    "33": 3,
    "34": 1,
    "35": 7,
    "36": 7,
    "37": 1,
    "38": 1,
    "39": 2,
    "40": 1,
    "41": 1,
    "42": 3,
    "43": 1,
    "44": 1,
    "45": 5,
    "46": 0,
    "47": 1,
    "48": 0,
    "49": 0,
    "50": 0,
    "51": 0,
    "52": 2,
    "53": 2,
    "54": 2
}