{
    "1": 7,
    "2": 6,
    "3": 5,
    "4": 5,
    "5": 4,
    "6": 5,
    "7": 4,
    "8": 3,
    "9": 3,
    "10": 2,
    "11": 1,
    "12": 4,
    "13": 5,
    "14": 7,
    "15": 5,
    "16": 3,
    "17": 2,
    "18": 6,
    "19": 5,
    "20": 0,
    "21": 4,
    "22": 6,
    "23": 2,
    "24": 2,
    "25": 1,
    "26": 0,
    "27": 1,
    "28": 7,
    "29": 4,
    "30": 6,
    "31": 5,
    "32": 4,
    "33": 6,
    "34": 7,
    "35": 3,
    "36": 4,
    "37": 0,
    "38": 7,
    "39": 1,
    "40": 3,
    "41": 1,
    "42": 2,
    "43": 2,
    "44": 3,
    "45": 0,
    "46": 5,
    "47": 4,
    "48": 3,
    "49": 6,
    "50": 6,
    "51": 0,
    "52": 7,
    "53": 7,
    "54": 7
}