{
    "1": 7,
    "2": 6,
    "3": 5,
    "4": 4,
    "5": 3,
    "6": 2,
    "7": 6,
    "8": 1,
    "9": 2,
    "10": 5,
    "11": 3,
    "12": 0,
    "13": 4,
    "14": 7,
    "15": 2,
    "16": 6,
    "17": 0,
    "18": 4,
    "19": 6,
    "20": 0,
    "21": 6,
    "22": 4,
    "23": 5,
    "24": 4,
    "25": 3,
    "26": 1,
    "27": 1,
    "28": 3,
    "29": 0,
    "30": 2,
    "31": 0,
    "32": 2,
    "33": 6,
    "34": 6,
    "35": 5,
    "36": 5,
    "37": 0,
    "38": 7,
    "39": 2,
    "40": 6,
    "41": 3,
    "42": 2,
    "43": 7,
    "44": 4,
    "45": 3,
    "46": 3,
    "47": 5,
    "48": 7,
    "49": 1,
    "50": 3,
    "51": 2,
    "52": 1,
    "53": 7,
    "54": 4,
    "55": 7,
    "56": 7,
    "57": 6,
    "58": 4,
    "59": 7,
    "60": 0
}