{
    "1": 5,
    "2": 4,
    "3": 3,
    "4": 2,
    "5": 3,
    "6": 1,
    "7": 4,
    "8": 3,
    "9": 3,
    "10": 4,
    "11": 3,
    "12": 2,
    "13": 5,
    "14": 3,
    "15": 0,
    "16": 1,
    "17": 0,
    "18": 0,
    "19": 0,
    "20": 3,
    "21": 4,
    "22": 0,
    "23": 3,
    "24": 4,
    "25": 0,
    "26": 0,
    "27": 2,
    "28": 0,
    "29": 5,
    "30": 5,
    "31": 4,
    "32": 5,
    "33": 5,
    "34": 2,
    "35": 1,
    "36": 3,
    "37": 2,
    "38": 3,
    "39": 2,
    "40": 1,
    "41": 1,
    "42": 1,
    "43": 5,
    "44": 4,
    "45": 1,
    "46": 1,
    "47": 3,
    "48": 4,
    "49": 5,
    "50": 0,
    "51": 2,
    "52": 5,
    "53": 1
}