{
    "1": 7,
    "2": 6,
    "3": 5,
    "4": 7,
    "5": 7,
    "6": 4,
    "7": 3,
    "8": 7,
    "9": 6,
    "10": 2,
    "11": 7,
    "12": 1,
    "13": 0,
    "14": 5,
    "15": 3,
    "16": 2,
    "17": 1,
    "18": 5,
    "19": 1,
    "20": 4,
    "21": 0,
    "22": 3,
    "23": 6,
    "24": 0,
    "25": 4,
    "26": 6,
    "27": 2,
    "28": 4,
    "29": 2,
    "30": 3,
    "31": 3,
    "32": 1,
    "33": 7,
    "34": 2,
    "35": 1,
    "36": 2,
    "37": 5,
    "38": 6,
    "39": 6,
    "40": 3,
    "41": 4,
    "42": 2,
    "43": 3,
    "44": 0,
    "45": 4,
    "46": 0,
    "47": 0,
    "48": 7,
    "49": 6,
    "50": 0,
    "51": 4,
    "52": 5,
    "53": 5,
    "54": 1
}