{
    "1": 7,
    "2": 6,
    "3": 5,
    "4": 6,
    "5": 6,
    "6": 6,
    "7": 6,
    "8": 4,
    "9": 5,
    "10": 6,
    "11": 6,
    "12": 3,
    "13": 6,
    "14": 2,
    "15": 1,
    "16": 2,
    "17": 7,
    "18": 1,
    "19": 1,
    "20": 1,
    "21": 5,
    "22": 5,
    "23": 0,
    "24": 3,
    "25": 0,
    "26": 2,
    "27": 7,
    "28": 0,
    "29": 7,
    "30": 2,
    "31": 2,
    "32": 4,
    "33": 1,
    "34": 1,
    "35": 1,
    "36": 3,
    "37": 5,
    "38": 3,
    "39": 0,
    "40": 4,
    "41": 5,
    "42": 6,
    "43": 6,
    "44": 6,
    "45": 4,
    "46": 7,
    "47": 3,
    "48": 0,
    "49": 2,
    "50": 4,
    "51": 0,
    "52": 4,
    "53": 7,
    "54": 4,
    "55": 3,
    "56": 0,
    "57": 7,
    "58": 5,
    "59": 3,
    "60": 2
}