{
    "1": 5,
    "2": 5,
    "3": 5,
    "4": 4,
    "5": 4,
    "6": 4,
    "7": 4,
    "8": 4,
    "9": 4,
    "10": 4,
    "11": 4,
    "12": 4,
    "13": 5,
    "14": 5,
    "15": 5,
    "16": 3,
    "17": 3,
    "18": 3,
    "19": 5,
    "20": 5,
    "21": 2,
    "22": 3,
    "23": 3,
    "24": 2,
    "25": 3,
    "26": 3,
    "27": 1,
    "28": 5,
    "29": 5,
    "30": 2,
    "31": 5,
    "32": 5,
    "33": 2,
    "34": 2,
    "35": 2,
    "36": 2,
    "37": 1,
    "38": 1,
    "39": 1,
    "40": 0,
    "41": 0,
    "42": 0,
    "43": 4,
    "44": 4,
    "45": 4,
    "46": 0,
    "47": 0,
    "48": 0,
    "49": 0,
    "50": 0,
    "51": 1,
    "52": 3,
    "53": 1
}