{
    "1": 7,
    "2": 7,
    "3": 7,
    "4": 6,
    "5": 6,
    "6": 5,
    "7": 5,
    "8": 6,
    "9": 7,
    "10": 7,
    "11": 6,
    "12": 6,
    "13": 4,
    "14": 4,
    "15": 3,
    "16": 4,
    "17": 4,
    "18": 3,
    "19": 4,
    "20": 4,
    "21": 3,
    "22": 3,
    "23": 7,
    "24": 3,
    "25": 3,
    "26": 5,
    "27": 2,
    "28": 3,
    "29": 2,
    "30": 2,
    "31": 2,
    "32": 2,
    "33": 4,
    "34": 1,
    "35": 2,
    "36": 5,
    "37": 1,
    "38": 2,
    "39": 5,
    "40": 1,
    "41": 1,
    "42": 5,
    "43": 1,
    "44": 1,
    "45": 0,
    "46": 0,
    "47": 1,
    "48": 0,
    "49": 0,
    "50": 0,
    "51": 0,
    "52": 7,
    "53": 7,
    "54": 0
}