{
    "1": 7,
    "2": 7,
    "3": 7,
    "4": 7,
    "5": 7,
    "6": 7,
    "7": 7,
    "8": 7,
    "9": 6,
    "10": 5,
    "11": 6,
    "12": 4,
    "13": 3,
    "14": 6,
    "15": 6,
    "16": 6,
    "17": 2,
    "18": 2,
    "19": 2,
    "20": 2,
    "21": 2,
    "22": 2,
    "23": 3,
    "24": 3,
    "25": 3,
    "26": 3,
    "27": 4,
    "28": 4,
    "29": 4,
    "30": 4,
    "31": 4,
    "32": 4,
    "33": 4,
    "34": 3,
    "35": 3,
    "36": 1,
    "37": 1,
    "38": 3,
    "39": 1,
    "40": 6,
    "41": 6,
    "42": 0,
    "43": 1,
    "44": 6,
    "45": 1,
    "46": 1,
    "47": 1,
    "48": 1,
    "49": 5,
    "50": 5,
    "51": 5,
    "52": 5,
    "53": 5,
    "54": 5,
    "55": 5,
    "56": 0,
    "57": 0,
    "58": 0,
    "59": 0,
    "60": 0
}