{
    "1": 7,
    "2": 6,
    "3": 6,
    "4": 7,
    "5": 7,
    "6": 7,
    "7": 7,
    "8": 7,
    "9": 7,
    "10": 7,
    "11": 5,
    "12": 7,
    "13": 7,
    "14": 4,
    "15": 7,
    "16": 3,
    "17": 3,
    "18": 4,
    "19": 3,
    "20": 3,
    "21": 4,
    "22": 4,
    "23": 6,
    "24": 4,
    "25": 4,
    "26": 5,
    "27": 2,
    "28": 4,
    "29": 2,
    "30": 2,
    "31": 2,
    "32": 2,
    "33": 6,
    "34": 1,
    "35": 2,
    "36": 6,
    "37": 1,
    "38": 2,
    "39": 5,
    "40": 1,
    "41": 1,
    "42": 3,
    "43": 1,
    "44": 1,
    "45": 0,
    "46": 0,
    "47": 1,
    "48": 0,
    "49": 0,
    "50": 0,
    "51": 0,
    "52": 5,
    "53": 5,
    "54": 0
}