{
    "1": 7,
    "2": 6,
    "3": 6,
    "4": 5,
    "5": 5,
    "6": 5,
    "7": 5,
    "8": 5,
    "9": 5,
    "10": 5,
    "11": 5,
    "12": 5,
    "13": 4,
    "14": 7,
    "15": 5,
    "16": 4,
    "17": 4,
    "18": 7,
    "19": 7,
    "20": 6,
    "21": 7,
    "22": 7,
    "23": 4,
    "24": 7,
    "25": 7,
    "26": 6,
    "27": 3,
    "28": 7,
    "29": 2,
    "30": 2,
    "31": 3,
    "32": 1,
    "33": 1,
    "34": 3,
    "35": 2,
    "36": 2,
    "37": 3,
    "38": 3,
    "39": 6,
    "40": 3,
    "41": 3,
    "42": 2,
    "43": 3,
    "44": 3,
    "45": 4,
    "46": 0,
    "47": 3,
    "48": 0,
    "49": 0,
    "50": 0,
    "51": 0,
    "52": 1,
    "53": 1,
    "54": 1
}