{
    "1": 5,
    "2": 5,
    "3": 5,
    "4": 5,
    "5": 5,
    "6": 5,
    "7": 4,
    "8": 4,
    "9": 4,
    "10": 4,
    "11": 4,
    "12": 4,
    "13": 3,
    "14": 3,
    "15": 3,
    "16": 3,
    "17": 3,
    "18": 3,
    "19": 3,
    "20": 3,
    "21": 2,
    "22": 1,
    "23": 1,
    "24": 1,
    "25": 1,
    "26": 1,
    "27": 1,
    "28": 2,
    "29": 2,
    "30": 2,
    "31": 2,
    "32": 2,
    "33": 2,
    "34": 0,
    "35": 0,
    "36": 0,
    "37": 0,
    "38": 0,
    "39": 0,
    "40": 5,
    "41": 5,
    "42": 0,
    "43": 3,
    "44": 3,
    "45": 0,
    "46": 1,
    "47": 1,
    "48": 1,
    "49": 4,
    "50": 4,
    "51": 4,
    "52": 4,
    "53": 2
}