{
    "1": 7,
    "2": 7,
    "3": 7,
    "4": 6,
    "5": 6,
    "6": 6,
    "7": 6,
    "8": 5,
    "9": 6,
    "10": 6,
    "11": 5,
    "12": 5,
    "13": 5,
    "14": 4,
    "15": 5,
    "16": 3,
    "17": 3,
    "18": 4,
    "19": 5,
    "20": 3,
    "21": 4,
    "22": 4,
    "23": 7,
    "24": 4,
    "25": 4,
    "26": 3,
    "27": 2,
    "28": 4,
    "29": 2,
    "30": 2,
    "31": 2,
    "32": 2,
    "33": 7,
    "34": 1,
    "35": 2,
    "36": 7,
    "37": 1,
    "38": 2,
    "39": 7,
    "40": 1,
    "41": 1,
    "42": 3,
    "43": 1,
    "44": 1,
    "45": 0,
    "46": 0,
    "47": 1,
    "48": 0,
    "49": 0,
    "50": 0,
    "51": 0,
    "52": 3,
    "53": 3,
    "54": 0
}