{
    "1": 7,
    "2": 7,
    "3": 7,
    "4": 7,
    "5": 7,
    "6": 7,
    "7": 7,
    "8": 7,
    "9": 6,
    "10": 5,
    "11": 6,
    "12": 4,
    "13": 4,
    "14": 6,
    "15": 6,
    "16": 6,
    "17": 5,
    "18": 5,
    "19": 5,
    "20": 5,
    "21": 5,
    "22": 5,
    "23": 3,
    "24": 3,
    "25": 3,
    "26": 3,
    "27": 2,
    "28": 2,
    "29": 2,
    "30": 2,
    "31": 2,
    "32": 2,
    "33": 2,
    "34": 3,
    "35": 3,
    "36": 1,
    "37": 1,
    "38": 3,
    "39": 1,
    "40": 6,
    "41": 6,
    "42": 2,
    "43": 1,
    "44": 6,
    "45": 1,
    "46": 1,
    "47": 1,
    "48": 1,
    "49": 0,
    "50": 0,
    "51": 0,
    "52": 0,
    "53": 0,
    "54": 0,
    "55": 0,
    "56": 5,
    "57": 4,
    "58": 4,
    "59": 4,
    "60": 4
}