{
    "1": 5,
    "2": 5,
    "3": 4,
    "4": 3,
    "5": 4,
    "6": 2,
    "7": 2,
    "8": 2,
    "9": 2,
    "10": 4,
    "11": 4,
    "12": 1,
    "13": 4,
    "14": 3,
    "15": 5,
    "16": 2,
    "17": 0,
    "18": 5,
    "19": 4,
    "20": 4,
    "21": 5,
    "22": 0,
    "23": 3,
    "24": 1,
    "25": 0,
    "26": 0,
    "27": 1,
    "28": 0,
    "29": 3,
    "30": 1,
    "31": 3,
    "32": 2,
    "33": 4,
    "34": 1,
    "35": 0,
    "36": 5,
    "37": 5,
    "38": 0,
    "39": 2,
    "40": 1,
    "41": 4,
    "42": 3,
    "43": 4,
    "44": 0,
    "45": 3,
    "46": 0,
    "47": 2,
    "48": 2,
    "49": 3,
    "50": 3,
    "51": 1,
    "52": 2,
    "53": 5
}