{
    "1": 7,
    "2": 6,
    "3": 5,
    "4": 7,
    "5": 7,
    "6": 4,
    "7": 6,
    "8": 7,
    "9": 3,
    "10": 2,
    "11": 7,
    "12": 1,
    "13": 0,
    "14": 1,
    "15": 2,
    "16": 3,
    "17": 6,
    "18": 2,
    "19": 4,
    "20": 5,
    "21": 5,
    "22": 0,
    "23": 6,
    "24": 0,
    "25": 1,
    "26": 2,
    "27": 5,
    "28": 3,
    "29": 0,
    "30": 6,
    "31": 7,
    "32": 0,
    "33": 5,
    "34": 6,
    "35": 4,
    "36": 0,
    "37": 3,
    "38": 3,
    "39": 4,
    "40": 2,
    "41": 4,
    "42": 1,
    "43": 4,
    "44": 3,
    "45": 5,
    "46": 3,
    "47": 1,
    "48": 1,
    "49": 2,
    "50": 6,
    "51": 4,
    "52": 5,
    "53": 0,
    "54": 1
}