{
    "1": 7,
    "2": 6,
    "3": 5,
    "4": 5,
    "5": 4,
    "6": 3,
    "7": 7,
    "8": 7,
    "9": 3,
    "10": 2,
    "11": 6,
    "12": 2,
    "13": 3,
    "14": 1,
    "15": 6,
    "16": 0,
    "17": 1,
    "18": 6,
    "19": 1,
    "20": 3,
    "21": 4,
    "22": 7,
    "23": 5,
    "24": 2,
    "25": 2,
    "26": 2,
    "27": 4,
    "28": 2,
    "29": 5,
    "30": 3,
    "31": 2,
    "32": 7,
    "33": 4,
    "34": 5,
    "35": 5,
    "36": 0,
    "37": 7,
    "38": 1,
    "39": 3,
    "40": 3,
    "41": 5,
    "42": 4,
    "43": 0,
    "44": 4,
    "45": 2,
    "46": 0,
    "47": 5,
    "48": 4,
    "49": 0,
    "50": 7,
    "51": 6,
    "52": 1,
    "53": 7,
    "54": 0,
    "55": 3,
    "56": 1,
    "57": 6,
    "58": 4,
    "59": 6,
    "60": 0
}