{
    "1": 5,
    "2": 5,
    "3": 5,
    "4": 4,
    "5": 4,
    "6": 4,
    "7": 4,
    "8": 4,
    "9": 4,
    "10": 4,
    "11": 4,
    "12": 4,
    "13": 3,
    "14": 3,
    "15": 3,
    "16": 3,
    "17": 3,
    "18": 3,
    "19": 3,
    "20": 3,
    "21": 2,
    "22": 1,
    "23": 1,
    "24": 1,
    "25": 1,
    "26": 1,
    "27": 2,
    "28": 1,
    "29": 1,
    "30": 0,
    "31": 1,
    "32": 1,
    "33": 0,
    "34": 0,
    "35": 0,
    "36": 0,
    "37": 2,
    "38": 2,
    "39": 2,
    "40": 1,
    "41": 1,
    "42": 4,
    "43": 5,
    "44": 5,
    "45": 5,
    "46": 5,
    "47": 5,
    "48": 5,
    "49": 3,
    "50": 3,
    "51": 2,
    "52": 4,
    "53": 0
}