{
    "1": 7,
    "2": 7,
    "3": 7,
    "4": 6,
    "5": 7,
    "6": 7,
    "7": 7,
    "8": 7,
    "9": 7,
    "10": 5,
    "11": 4,
    "12": 3,
    "13": 2,
    "14": 7,
    "15": 4,
    "16": 4,
    "17": 3,
    "18": 3,
    "19": 3,
    "20": 3,
    "21": 3,
    "22": 3,
    "23": 3,
    "24": 4,
    "25": 6,
    "26": 2,
    "27": 2,
    "28": 2,
    "29": 2,
    "30": 2,
    "31": 2,
    "32": 1,
    "33": 1,
    "34": 6,
    "35": 6,
    "36": 6,
    "37": 6,
    "38": 6,
    "39": 6,
    "40": 4,
    "41": 4,
    "42": 0,
    "43": 1,
    "44": 4,
    "45": 1,
    "46": 1,
    "47": 1,
    "48": 4,
    "49": 5,
    "50": 5,
    "51": 5,
    "52": 5,
    "53": 5,
    "54": 5,
    "55": 5,
    "56": 0,
    "57": 0,
    "58": 0,
    "59": 0,
    "60": 0
}