{
    "1": 5,
    "2": 4,
    "3": 4,
    "4": 3,
    "5": 2,
    "6": 1,
    "7": 0,
    "8": 0,
    "9": 1,
    "10": 5,
    "11": 5,
    "12": 4,
    "13": 4,
    "14": 0,
    "15": 1,
    "16": 5,
    "17": 3,
    "18": 1,
    "19": 1,
    "20": 2,
    "21": 2,
    "22": 3,
    "23": 3,
    "24": 0,
    "25": 1,
    "26": 4,
    "27": 5,
    "28": 2,
    "29": 1,
    "30": 1,
    "31": 4,
    "32": 3,
    "33": 1,
    "34": 1,
    "35": 1,
    "36": 3,
    "37": 4,
    "38": 0,
    "39": 5,
    "40": 4,
    "41": 5,
    "42": 3,
    "43": 2,
    "44": 4,
    "45": 3,
    "46": 1,
    "47": 5,
    "48": 4,
    "49": 0,
    "50": 2,
    "51": 4,
    "52": 5,
    "53": 2
}