{
    "1": 7,
    "2": 7,
    "3": 6,
    "4": 6,
    "5": 6,
    "6": 7,
    "7": 6,
    "8": 6,
    "9": 5,
    "10": 5,
    "11": 5,
    "12": 5,
    "13": 5,
    "14": 6,
    "15": 5,
    "16": 5,
    "17": 4,
    "18": 4,
    "19": 4,
    "20": 4,
    "21": 4,
    "22": 4,
    "23": 4,
    "24": 5,
    "25": 3,
    "26": 7,
    "27": 7,
    "28": 7,
    "29": 7,
    "30": 7,
    "31": 7,
    "32": 6,
    "33": 6,
    "34": 3,
    "35": 3,
    "36": 3,
    "37": 3,
    "38": 3,
    "39": 3,
    "40": 5,
    "41": 5,
    "42": 2,
    "43": 2,
    "44": 5,
    "45": 2,
    "46": 2,
    "47": 2,
    "48": 2,
    "49": 1,
    "50": 1,
    "51": 1,
    "52": 1,
    "53": 1,
    "54": 1,
    "55": 1,
    "56": 0,
    "57": 0,
    "58": 0,
    "59": 0,
    "60": 0
}