{
    "1": 7,
    "2": 6,
    "3": 5,
    "4": 7,
    "5": 7,
    "6": 4,
    "7": 3,
    "8": 7,
    "9": 6,
    "10": 2,
    "11": 7,
    "12": 3,
    "13": 3,
    "14": 6,
    "15": 4,
    "16": 5,
    "17": 3,
    "18": 1,
    "19": 5,
    "20": 5,
    "21": 6,
    "22": 6,
    "23": 0,
    "24": 2,
    "25": 2,
    "26": 2,
    "27": 5,
    "28": 5,
    "29": 4,
    "30": 5,
    "31": 4,
    "32": 4,
    "33": 2,
    "34": 0,
    "35": 6,
    "36": 4,
    "37": 4,
    "38": 3,
    "39": 1,
    "40": 0,
    "41": 1,
    "42": 2,
    "43": 1,
    "44": 0,
    "45": 0,
    "46": 0,
    "47": 0,
    "48": 1,
    "49": 2,
    "50": 3,
    "51": 1,
    "52": 1,
    "53": 3,
    "54": 6
}