{
    "1": 7,
    "2": 6,
    "3": 6,
    "4": 5,
    "5": 5,
    "6": 5,
    "7": 5,
    "8": 5,
    "9": 5,
    "10": 5,
    "11": 5,
    "12": 5,
    "13": 4,
    "14": 3,
    "15": 5,
    "16": 2,
    "17": 2,
    "18": 3,
    "19": 3,
    "20": 1,
    "21": 3,
    "22": 3,
    "23": 1,
    "24": 3,
    "25": 3,
    "26": 6,
    "27": 7,
    "28": 3,
    "29": 2,
    "30": 2,
    "31": 7,
    "32": 1,
    "33": 1,
    "34": 7,
    "35": 6,
    "36": 6,
    "37": 7,
    "38": 7,
    "39": 2,
    "40": 7,
    "41": 7,
    "42": 4,
    "43": 7,
    "44": 7,
    "45": 1,
    "46": 0,
    "47": 7,
    "48": 0,
    "49": 0,
    "50": 0,
    "51": 0,
    "52": 4,
    "53": 4,
    "54": 4
}