{
    "1": 7,
    "2": 7,
    "3": 7,
    "4": 7,
    "5": 7,
    "6": 7,
    "7": 7,
    "8": 7,
    "9": 7,
    "10": 6,
    "11": 6,
    "12": 7,
    "13": 7,
    "14": 5,
    "15": 5,
    "16": 5,
    "17": 4,
    "18": 4,
    "19": 4,
    "20": 4,
    "21": 6,
    "22": 4,
    "23": 6,
    "24": 6,
    "25": 6,
    "26": 3,
    "27": 3,
    "28": 2,
    "29": 3,
    "30": 3,
    "31": 3,
    "32": 2,
    "33": 2,
    "34": 6,
    "35": 6,
    "36": 6,
    "37": 6,
    "38": 6,
    "39": 6,
    "40": 5,
    "41": 5,
    "42": 5,
    "43": 5,
    "44": 5,
    "45": 5,
    "46": 5,
    "47": 5,
    "48": 5,
    "49": 2,
    "50": 1,
    "51": 1,
    "52": 1,
    "53": 1,
    "54": 1,
    "55": 2,
    "56": 0,
    "57": 0,
    "58": 0,
    "59": 0,
    "60": 0
}