{
    "1": 7,
    "2": 7,
    "3": 7,
    "4": 6,
    "5": 6,
    "6": 6,
    "7": 6,
    "8": 6,
    "9": 6,
    "10": 6,
    "11": 6,
    "12": 6,
    "13": 5,
    "14": 4,
    "15": 6,
    "16": 3,
    "17": 3,
    "18": 4,
    "19": 4,
    "20": 3,
    "21": 4,
    "22": 4,
    "23": 5,
    "24": 4,
    "25": 4,
    "26": 5,
    "27": 2,
    "28": 4,
    "29": 7,
    "30": 7,
    "31": 2,
    "32": 1,
    "33": 1,
    "34": 2,
    "35": 5,
    "36": 5,
    "37": 2,
    "38": 2,
    "39": 7,
    "40": 2,
    "41": 2,
    "42": 3,
    "43": 2,
    "44": 2,
    "45": 3,
    "46": 0,
    "47": 2,
    "48": 0,
    "49": 0,
    "50": 0,
    "51": 0,
    "52": 1,
    "53": 1,
    "54": 1
}