{
    "1": 7,
    "2": 7,
    "3": 7,
    "4": 6,
    "5": 7,
    "6": 7,
    "7": 7,
    "8": 7,
    "9": 5,
    "10": 5,
    "11": 5,
    "12": 5,
    "13": 5,
    "14": 7,
    "15": 5,
    "16": 5,
    "17": 4,
    "18": 4,
    "19": 4,
    "20": 4,
    "21": 4,
    "22": 4,
    "23": 3,
    "24": 3,
    "25": 3,
    "26": 3,
    "27": 2,
    "28": 2,
    "29": 2,
    "30": 2,
    "31": 2,
    "32": 6,
    "33": 6,
    "34": 3,
    "35": 3,
    "36": 6,
    "37": 6,
    "38": 3,
    "39": 6,
    "40": 5,
    "41": 5,
    "42": 5,
    "43": 5,
    "44": 5,
    "45": 5,
    "46": 5,
    "47": 1,
    "48": 1,
    "49": 1,
    "50": 1,
    "51": 1,
    "52": 1,
    "53": 1,
    "54": 1,
    "55": 3,
    "56": 0,
    "57": 0,
    "58": 0,
    "59": 0,
    "60": 0
}