{
    "1": 5,
    "2": 5,
    "3": 5,
    "4": 4,
    "5": 4,
    "6": 4,
    "7": 4,
    "8": 4,
    "9": 4,
    "10": 4,
    "11": 4,
    "12": 4,
    "13": 5,
    "14": 5,
    "15": 5,
    "16": 5,
    "17": 5,
    "18": 5,
    "19": 5,
    "20": 5,
    "21": 5,
    "22": 3,
    "23": 3,
    "24": 3,
    "25": 3,
    "26": 3,
    "27": 3,
    "28": 3,
    "29": 3,
    "30": 3,
    "31": 2,
    "32": 2,
    "33": 2,
    "34": 2,
    "35": 2,
    "36": 2,
    "37": 2,
    "38": 2,
    "39": 2,
    "40": 2,
    "41": 2,
    "42": 2,
    "43": 1,
    "44": 1,
    "45": 1,
    "46": 1,
    "47": 1,
    "48": 1,
    "49": 0,
    "50": 0,
    "51": 0,
    "52": 0,
    "53": 0
}