{
    "1": 5,
    "2": 5,
    "3": 5,
    "4": 4,
    "5": 4,
    "6": 4,
    "7": 4,
    "8": 4,
    "9": 4,
    "10": 4,
    "11": 4,
    "12": 4,
    "13": 3,
    "14": 3,
    "15": 3,
    "16": 3,
    "17": 3,
    "18": 3,
    "19": 3,
    "20": 3,
    "21": 2,
    "22": 1,
    "23": 1,
    "24": 1,
    "25": 1,
    "26": 1,
    "27": 1,
    "28": 1,
    "29": 1,
    "30": 1,
    "31": 1,
    "32": 1,
    "33": 2,
    "34": 0,
    "35": 0,
    "36": 0,
    "37": 2,
    "38": 2,
    "39": 2,
    "40": 0,
    "41": 0,
    "42": 0,
    "43": 5,
    "44": 5,
    "45": 5,
    "46": 0,
    "47": 0,
    "48": 0,
    "49": 5,
    "50": 5,
    "51": 5,
    "52": 5,
    "53": 2
}