{
    "1": 7,
    "2": 7,
    "3": 7,
    "4": 6,
    "5": 6,
    "6": 6,
    "7": 6,
    "8": 6,
    "9": 6,
    "10": 6,
    "11": 6,
    "12": 6,
    "13": 6,
    "14": 5,
    "15": 6,
    "16": 7,
    "17": 7,
    "18": 5,
    "19": 4,
    "20": 4,
    "21": 5,
    "22": 5,
    "23": 4,
    "24": 5,
    "25": 5,
    "26": 7,
    "27": 3,
    "28": 5,
    "29": 3,
    "30": 3,
    "31": 3,
    "32": 3,
    "33": 2,
    "34": 1,
    "35": 3,
    "36": 4,
    "37": 1,
    "38": 3,
    "39": 2,
    "40": 1,
    "41": 1,
    "42": 4,
    "43": 1,
    "44": 1,
    "45": 0,
    "46": 0,
    "47": 1,
    "48": 0,
    "49": 0,
    "50": 0,
    "51": 0,
    "52": 2,
    "53": 2,
    "54": 2
}