{
    "1": 7,
    "2": 7,
    "3": 7,
    "4": 6,
    "5": 7,
    "6": 7,
    "7": 7,
    "8": 7,
    "9": 5,
    "10": 5,
    "11": 5,
    "12": 5,
    "13": 5,
    "14": 7,
    "15": 5,
    "16": 5,
    "17": 4,
    "18": 4,
    "19": 4,
    "20": 4,
    "21": 4,
    "22": 4,
    "23": 4,
    "24": 5,
    "25": 6,
    "26": 3,
    "27": 3,
    "28": 3,
    "29": 3,
    "30": 3,
    "31": 3,
    "32": 7,
    "33": 7,
    "34": 6,
    "35": 6,
    "36": 6,
    "37": 6,
    "38": 6,
    "39": 6,
    "40": 5,
    "41": 5,
    "42": 2,
    "43": 2,
    "44": 5,
    "45": 2,
    "46": 2,
    "47": 2,
    "48": 2,
    "49": 1,
    "50": 1,
    "51": 1,
    "52": 1,
    "53": 1,
    "54": 1,
    "55": 1,
    "56": 0,
    "57": 0,
    "58": 0,
    "59": 0,
    "60": 0
}