{
    "1": 5,
    "2": 5,
    "3": 5,
    "4": 4,
    "5": 4,
    "6": 4,
    "7": 4,
    "8": 4,
    "9": 4,
    "10": 4,
    "11": 4,
    "12": 4,
    "13": 3,
    "14": 3,
    "15": 3,
    "16": 5,
    "17": 5,
    "18": 5,
    "19": 5,
    "20": 5,
    "21": 2,
    "22": 2,
    "23": 2,
    "24": 2,
    "25": 2,
    "26": 2,
    "27": 2,
    "28": 2,
    "29": 2,
    "30": 2,
    "31": 2,
    "32": 1,
    "33": 1,
    "34": 1,
    "35": 1,
    "36": 1,
    "37": 1,
    "38": 1,
    "39": 1,
    "40": 1,
    "41": 1,
    "42": 4,
    "43": 3,
    "44": 3,
    "45": 3,
    "46": 0,
    "47": 0,
    "48": 0,
    "49": 0,
    "50": 0,
    "51": 0,
    "52": 5,
    "53": 2
}