{
    "1": 7,
    "2": 6,
    "3": 6,
    "4": 7,
    "5": 7,
    "6": 7,
    "7": 7,
    "8": 7,
    "9": 7,
    "10": 7,
    "11": 7,
    "12": 7,
    "13": 5,
    "14": 4,
    "15": 7,
    "16": 5,
    "17": 5,
    "18": 4,
    "19": 4,
    "20": 3,
    "21": 4,
    "22": 4,
    "23": 3,
    "24": 4,
    "25": 4,
    "26": 3,
    "27": 2,
    "28": 4,
    "29": 5,
    "30": 5,
    "31": 2,
    "32": 1,
    "33": 1,
    "34": 2,
    "35": 1,
    "36": 1,
    "37": 2,
    "38": 2,
    "39": 1,
    "40": 2,
    "41": 2,
    "42": 3,
    "43": 2,
    "44": 2,
    "45": 3,
    "46": 0,
    "47": 2,
    "48": 0,
    "49": 0,
    "50": 0,
    "51": 0,
    "52": 6,
    "53": 6,
    "54": 6
}