{
    "1": 5,
    "2": 5,
    "3": 5,
    "4": 4,
    "5": 4,
    "6": 4,
    "7": 4,
    "8": 4,
    "9": 4,
    "10": 4,
    "11": 4,
    "12": 4,
    "13": 5,
    "14": 5,
    "15": 5,
    "16": 3,
    "17": 3,
    "18": 3,
    "19": 5,
    "20": 5,
    "21": 2,
    "22": 1,
    "23": 1,
    "24": 1,
    "25": 1,
    "26": 1,
    "27": 2,
    "28": 3,
    "29": 3,
    "30": 2,
    "31": 1,
    "32": 1,
    "33": 0,
    "34": 0,
    "35": 0,
    "36": 0,
    "37": 0,
    "38": 0,
    "39": 0,
    "40": 0,
    "41": 0,
    "42": 4,
    "43": 3,
    "44": 3,
    "45": 3,
    "46": 5,
    "47": 5,
    "48": 5,
    "49": 1,
    "50": 1,
    "51": 2,
    "52": 4,
    "53": 2
}