{
    "1": 7,
    "2": 7,
    "3": 7,
    "4": 6,
    "5": 6,
    "6": 6,
    "7": 6,
    "8": 6,
    "9": 6,
    "10": 6,
    "11": 6,
    "12": 6,
    "13": 7,
    "14": 5,
    "15": 6,
    "16": 4,
    "17": 4,
    "18": 5,
    "19": 3,
    "20": 3,
    "21": 5,
    "22": 5,
    "23": 4,
    "24": 5,
    "25": 5,
    "26": 3,
    "27": 2,
    "28": 5,
    "29": 2,
    "30": 2,
    "31": 2,
    "32": 2,
    "33": 7,
    "34": 1,
    "35": 2,
    "36": 7,
    "37": 1,
    "38": 2,
    "39": 4,
    "40": 1,
    "41": 1,
    "42": 4,
    "43": 1,
    "44": 1,
    "45": 0,
    "46": 0,
    "47": 1,
    "48": 0,
    "49": 0,
    "50": 0,
    "51": 0,
    "52": 3,
    "53": 3,
    "54": 0
}