{
    "1": 7,
    "2": 7,
    "3": 7,
    "4": 6,
    "5": 5,
    "6": 5,
    "7": 5,
    "8": 5,
    "9": 4,
    "10": 3,
    "11": 4,
    "12": 4,
    "13": 4,
    "14": 5,
    "15": 4,
    "16": 4,
    "17": 3,
    "18": 3,
    "19": 3,
    "20": 3,
    "21": 2,
    "22": 3,
    "23": 2,
    "24": 2,
    "25": 2,
    "26": 1,
    "27": 1,
    "28": 6,
    "29": 1,
    "30": 1,
    "31": 1,
    "32": 1,
    "33": 1,
    "34": 2,
    "35": 2,
    "36": 5,
    "37": 5,
    "38": 2,
    "39": 5,
    "40": 4,
    "41": 4,
    "42": 6,
    "43": 6,
    "44": 4,
    "45": 6,
    "46": 6,
    "47": 6,
    "48": 6,
    "49": 6,
    "50": 7,
    "51": 7,
    "52": 7,
    "53": 7,
    "54": 7,
    "55": 7,
    "56": 0,
    "57": 0,
    "58": 0,
    "59": 0,
    "60": 0
}