{
    "1": 5,
    "2": 4,
    "3": 4,
    "4": 3,
    "5": 3,
    "6": 3,
    "7": 3,
    "8": 3,
    "9": 3,
    "10": 3,
    "11": 3,
    "12": 2,
    "13": 2,
    "14": 2,
    "15": 2,
    "16": 2,
    "17": 2,
    "18": 2,
    "19": 2,
    "20": 2,
    "21": 5,
    "22": 4,
    "23": 4,
    "24": 5,
    "25": 1,
    "26": 1,
    "27": 1,
    "28": 1,
    "29": 4,
    "30": 5,
    "31": 0,
    "32": 4,
    "33": 5,
    "34": 0,
    "35": 0,
    "36": 0,
    "37": 1,
    "38": 1,
    "39": 1,
    "40": 0,
    "41": 0,
    "42": 0,
    "43": 1,
    "44": 1,
    "45": 1,
    "46": 0,
    "47": 0,
    "48": 0,
    "49": 4,
    "50": 4,
    "51": 5,
    "52": 2,
    "53": 5
}