{
    "1": 7,
    "2": 6,
    "3": 6,
    "4": 5,
    "5": 5,
    "6": 6,
    "7": 6,
    "8": 5,
    "9": 4,
    "10": 4,
    "11": 5,
    "12": 5,
    "13": 5,
    "14": 3,
    "15": 5,
    "16": 2,
    "17": 2,
    "18": 3,
    "19": 3,
    "20": 4,
    "21": 3,
    "22": 3,
    "23": 4,
    "24": 3,
    "25": 3,
    "26": 7,
    "27": 7,
    "28": 3,
    "29": 7,
    "30": 6,
    "31": 1,
    "32": 7,
    "33": 4,
    "34": 1,
    "35": 7,
    "36": 2,
    "37": 1,
    "38": 7,
    "39": 6,
    "40": 1,
    "41": 1,
    "42": 4,
    "43": 1,
    "44": 1,
    "45": 0,
    "46": 0,
    "47": 1,
    "48": 0,
    "49": 0,
    "50": 0,
    "51": 0,
    "52": 2,
    "53": 2,
    "54": 2
}