{
    "1": 7,
    "2": 7,
    "3": 7,
    "4": 6,
    "5": 5,
    "6": 5,
    "7": 5,
    "8": 5,
    "9": 5,
    "10": 4,
    "11": 4,
    "12": 4,
    "13": 3,
    "14": 5,
    "15": 3,
    "16": 3,
    "17": 6,
    "18": 6,
    "19": 6,
    "20": 6,
    "21": 6,
    "22": 6,
    "23": 4,
    "24": 3,
    "25": 4,
    "26": 2,
    "27": 2,
    "28": 2,
    "29": 2,
    "30": 2,
    "31": 2,
    "32": 5,
    "33": 5,
    "34": 4,
    "35": 4,
    "36": 1,
    "37": 3,
    "38": 4,
    "39": 3,
    "40": 3,
    "41": 3,
    "42": 2,
    "43": 1,
    "44": 3,
    "45": 1,
    "46": 1,
    "47": 1,
    "48": 1,
    "49": 0,
    "50": 0,
    "51": 1,
    "52": 0,
    "53": 0,
    "54": 0,
    "55": 0,
    "56": 7,
    "57": 7,
    "58": 7,
    "59": 7,
    "60": 7
}