{
    "1": 5,
    "2": 5,
    "3": 5,
    "4": 5,
    "5": 5,
    "6": 5,
    "7": 5,
    "8": 5,
    "9": 5,
    "10": 5,
    "11": 5,
    "12": 5,
    "13": 4,
    "14": 4,
    "15": 4,
    "16": 4,
    "17": 4,
    "18": 4,
    "19": 3,
    "20": 3,
    "21": 2,
    "22": 2,
    "23": 2,
    "24": 2,
    "25": 2,
    "26": 2,
    "27": 2,
    "28": 2,
    "29": 2,
    "30": 2,
    "31": 3,
    "32": 3,
    "33": 3,
    "34": 1,
    "35": 1,
    "36": 1,
    "37": 0,
    "38": 0,
    "39": 0,
    "40": 3,
    "41": 3,
    "42": 2,
    "43": 0,
    "44": 0,
    "45": 0,
    "46": 1,
    "47": 1,
    "48": 1,
    "49": 1,
    "50": 1,
    "51": 1,
    "52": 1,
    "53": 1
}