{
    "1": 7,
    "2": 7,
    "3": 7,
    "4": 7,
    "5": 7,
    "6": 7,
    "7": 7,
    "8": 7,
    "9": 6,
    "10": 6,
    "11": 6,
    "12": 6,
    "13": 6,
    "14": 7,
    "15": 5,
    "16": 4,
    "17": 4,
    "18": 4,
    "19": 4,
    "20": 4,
    "21": 4,
    "22": 4,
    "23": 3,
    "24": 4,
    "25": 3,
    "26": 2,
    "27": 2,
    "28": 2,
    "29": 2,
    "30": 2,
    "31": 2,
    "32": 2,
    "33": 2,
    "34": 3,
    "35": 3,
    "36": 3,
    "37": 3,
    "38": 3,
    "39": 3,
    "40": 5,
    "41": 5,
    "42": 6,
    "43": 6,
    "44": 5,
    "45": 5,
    "46": 5,
    "47": 5,
    "48": 5,
    "49": 1,
    "50": 1,
    "51": 1,
    "52": 1,
    "53": 1,
    "54": 1,
    "55": 6,
    "56": 0,
    "57": 0,
    "58": 0,
    "59": 0,
    "60": 0
}