{
    "1": 7,
    "2": 7,
    "3": 6,
    "4": 5,
    "5": 6,
    "6": 7,
    "7": 6,
    "8": 6,
    "9": 6,
    "10": 5,
    "11": 4,
    "12": 4,
    "13": 4,
    "14": 6,
    "15": 4,
    "16": 4,
    "17": 3,
    "18": 3,
    "19": 3,
    "20": 3,
    "21": 3,
    "22": 3,
    "23": 3,
    "24": 2,
    "25": 2,
    "26": 2,
    "27": 5,
    "28": 5,
    "29": 5,
    "30": 5,
    "31": 5,
    "32": 3,
    "33": 3,
    "34": 2,
    "35": 2,
    "36": 2,
    "37": 2,
    "38": 2,
    "39": 2,
    "40": 4,
    "41": 4,
    "42": 1,
    "43": 1,
    "44": 4,
    "45": 1,
    "46": 1,
    "47": 1,
    "48": 1,
    "49": 1,
    "50": 0,
    "51": 0,
    "52": 0,
    "53": 0,
    "54": 0,
    "55": 6,
    "56": 7,
    "57": 7,
    "58": 7,
    "59": 7,
    "60": 7
}