{
    "1": 5,
    "2": 5,
    "3": 5,
    "4": 5,
    "5": 5,
    "6": 5,
    "7": 4,
    "8": 4,
    "9": 4,
    "10": 4,
    "11": 4,
    "12": 4,
    "13": 3,
    "14": 3,
    "15": 3,
    "16": 2,
    "17": 2,
    "18": 2,
    "19": 3,
    "20": 3,
    "21": 5,
    "22": 1,
    "23": 1,
    "24": 1,
    "25": 4,
    "26": 4,
    "27": 4,
    "28": 1,
    "29": 1,
    "30": 1,
    "31": 1,
    "32": 1,
    "33": 1,
    "34": 0,
    "35": 0,
    "36": 0,
    "37": 2,
    "38": 2,
    "39": 2,
    "40": 3,
    "41": 3,
    "42": 0,
    "43": 5,
    "44": 5,
    "45": 5,
    "46": 2,
    "47": 2,
    "48": 2,
    "49": 3,
    "50": 3,
    "51": 0,
    "52": 0,
    "53": 0
}