{
    "1": 7,
    "2": 6,
    "3": 6,
    "4": 6,
    "5": 7,
    "6": 6,
    "7": 6,
    "8": 7,
    "9": 7,
    "10": 7,
    "11": 5,
    "12": 7,
    "13": 7,
    "14": 4,
    "15": 5,
    "16": 5,
    "17": 5,
    "18": 4,
    "19": 5,
    "20": 5,
    "21": 4,
    "22": 4,
    "23": 3,
    "24": 4,
    "25": 4,
    "26": 3,
    "27": 2,
    "28": 4,
    "29": 2,
    "30": 2,
    "31": 2,
    "32": 2,
    "33": 6,
    "34": 1,
    "35": 2,
    "36": 3,
    "37": 1,
    "38": 2,
    "39": 3,
    "40": 1,
    "41": 1,
    "42": 0,
    "43": 1,
    "44": 1,
    "45": 0,
    "46": 0,
    "47": 1,
    "48": 0,
    "49": 0,
    "50": 0,
    "51": 0,
    "52": 3,
    "53": 3,
    "54": 3
}