{
    "0": 13,
    "1": 13,
    "2": 13,
    "3": 12,
    "4": 14,
    "5": 4,
    "6": 4,
    "7": 6
}