{
    "1": 7,
    "2": 7,
    "3": 7,
    "4": 7,
    "5": 7,
    "6": 7,
    "7": 7,
    "8": 7,
    "9": 7,
    "10": 6,
    "11": 5,
    "12": 7,
    "13": 4,
    "14": 4,
    "15": 4,
    "16": 4,
    "17": 6,
    "18": 6,
    "19": 6,
    "20": 6,
    "21": 6,
    "22": 6,
    "23": 3,
    "24": 3,
    "25": 3,
    "26": 3,
    "27": 2,
    "28": 2,
    "29": 2,
    "30": 2,
    "31": 2,
    "32": 2,
    "33": 2,
    "34": 3,
    "35": 3,
    "36": 1,
    "37": 1,
    "38": 3,
    "39": 1,
    "40": 4,
    "41": 4,
    "42": 5,
    "43": 5,
    "44": 4,
    "45": 5,
    "46": 5,
    "47": 5,
    "48": 5,
    "49": 5,
    "50": 0,
    "51": 0,
    "52": 0,
    "53": 0,
    "54": 0,
    "55": 0,
    "56": 1,
    "57": 1,
    "58": 0,
    "59": 1,
    "60": 1
}