{
    "1": 5,
    "2": 5,
    "3": 5,
    "4": 4,
    "5": 4,
    "6": 4,
    "7": 3,
    "8": 3,
    "9": 3,
    "10": 4,
    "11": 4,
    "12": 4,
    "13": 5,
    "14": 5,
    "15": 5,
    "16": 3,
    "17": 3,
    "18": 3,
    "19": 3,
    "20": 3,
    "21": 2,
    "22": 1,
    "23": 1,
    "24": 1,
    "25": 1,
    "26": 1,
    "27": 2,
    "28": 1,
    "29": 1,
    "30": 2,
    "31": 1,
    "32": 1,
    "33": 0,
    "34": 0,
    "35": 0,
    "36": 0,
    "37": 2,
    "38": 2,
    "39": 2,
    "40": 0,
    "41": 0,
    "42": 5,
    "43": 4,
    "44": 4,
    "45": 4,
    "46": 5,
    "47": 5,
    "48": 5,
    "49": 3,
    "50": 3,
    "51": 2,
    "52": 4,
    "53": 2
}