{
    "1": 7,
    "2": 7,
    "3": 6,
    "4": 5,
    "5": 6,
    "6": 7,
    "7": 6,
    "8": 6,
    "9": 6,
    "10": 4,
    "11": 3,
    "12": 3,
    "13": 3,
    "14": 6,
    "15": 3,
    "16": 4,
    "17": 4,
    "18": 4,
    "19": 4,
    "20": 4,
    "21": 4,
    "22": 4,
    "23": 5,
    "24": 5,
    "25": 5,
    "26": 5,
    "27": 2,
    "28": 2,
    "29": 2,
    "30": 2,
    "31": 2,
    "32": 2,
    "33": 2,
    "34": 5,
    "35": 5,
    "36": 1,
    "37": 1,
    "38": 5,
    "39": 1,
    "40": 3,
    "41": 3,
    "42": 0,
    "43": 1,
    "44": 3,
    "45": 1,
    "46": 1,
    "47": 1,
    "48": 1,
    "49": 0,
    "50": 0,
    "51": 0,
    "52": 0,
    "53": 0,
    "54": 0,
    "55": 0,
    "56": 6,
    "57": 7,
    "58": 7,
    "59": 7,
    "60": 7
}