{
    "1": 7,
    "2": 7,
    "3": 7,
    "4": 6,
    "5": 6,
    "6": 6,
    "7": 6,
    "8": 6,
    "9": 6,
    "10": 6,
    "11": 6,
    "12": 6,
    "13": 5,
    "14": 4,
    "15": 6,
    "16": 5,
    "17": 5,
    "18": 4,
    "19": 4,
    "20": 3,
    "21": 4,
    "22": 4,
    "23": 7,
    "24": 4,
    "25": 4,
    "26": 5,
    "27": 2,
    "28": 4,
    "29": 1,
    "30": 1,
    "31": 2,
    "32": 1,
    "33": 1,
    "34": 2,
    "35": 7,
    "36": 7,
    "37": 2,
    "38": 2,
    "39": 1,
    "40": 2,
    "41": 2,
    "42": 3,
    "43": 2,
    "44": 2,
    "45": 5,
    "46": 0,
    "47": 2,
    "48": 0,
    "49": 0,
    "50": 0,
    "51": 0,
    "52": 3,
    "53": 3,
    "54": 3
}