{
    "1": 7,
    "2": 6,
    "3": 6,
    "4": 7,
    "5": 7,
    "6": 7,
    "7": 7,
    "8": 7,
    "9": 7,
    "10": 7,
    "11": 7,
    "12": 7,
    "13": 5,
    "14": 4,
    "15": 7,
    "16": 5,
    "17": 5,
    "18": 4,
    "19": 4,
    "20": 6,
    "21": 4,
    "22": 4,
    "23": 6,
    "24": 4,
    "25": 4,
    "26": 6,
    "27": 3,
    "28": 4,
    "29": 5,
    "30": 5,
    "31": 3,
    "32": 2,
    "33": 2,
    "34": 3,
    "35": 2,
    "36": 2,
    "37": 3,
    "38": 3,
    "39": 2,
    "40": 3,
    "41": 3,
    "42": 1,
    "43": 3,
    "44": 3,
    "45": 1,
    "46": 0,
    "47": 3,
    "48": 0,
    "49": 0,
    "50": 0,
    "51": 0,
    "52": 1,
    "53": 1,
    "54": 1
}