{
    "1": 5,
    "2": 5,
    "3": 5,
    "4": 4,
    "5": 4,
    "6": 4,
    "7": 3,
    "8": 3,
    "9": 3,
    "10": 3,
    "11": 3,
    "12": 3,
    "13": 2,
    "14": 2,
    "15": 2,
    "16": 2,
    "17": 2,
    "18": 2,
    "19": 1,
    "20": 1,
    "21": 1,
    "22": 5,
    "23": 0,
    "24": 3,
    "25": 5,
    "26": 0,
    "27": 0,
    "28": 3,
    "29": 0,
    "30": 0,
    "31": 3,
    "32": 0,
    "33": 0,
    "34": 4,
    "35": 4,
    "36": 4,
    "37": 4,
    "38": 4,
    "39": 4,
    "40": 0,
    "41": 0,
    "42": 5,
    "43": 2,
    "44": 2,
    "45": 2,
    "46": 1,
    "47": 1,
    "48": 1,
    "49": 1,
    "50": 1,
    "51": 1,
    "52": 5,
    "53": 5
}