{
    "1": 7,
    "2": 7,
    "3": 7,
    "4": 7,
    "5": 6,
    "6": 7,
    "7": 7,
    "8": 5,
    "9": 5,
    "10": 5,
    "11": 4,
    "12": 4,
    "13": 4,
    "14": 3,
    "15": 4,
    "16": 4,
    "17": 4,
    "18": 3,
    "19": 3,
    "20": 7,
    "21": 3,
    "22": 3,
    "23": 5,
    "24": 3,
    "25": 3,
    "26": 2,
    "27": 2,
    "28": 3,
    "29": 2,
    "30": 2,
    "31": 1,
    "32": 2,
    "33": 2,
    "34": 1,
    "35": 2,
    "36": 6,
    "37": 1,
    "38": 2,
    "39": 5,
    "40": 1,
    "41": 1,
    "42": 5,
    "43": 1,
    "44": 1,
    "45": 6,
    "46": 0,
    "47": 1,
    "48": 0,
    "49": 0,
    "50": 0,
    "51": 0,
    "52": 6,
    "53": 6,
    "54": 6
}