{
    "1": 7,
    "2": 7,
    "3": 6,
    "4": 6,
    "5": 6,
    "6": 6,
    "7": 6,
    "8": 6,
    "9": 6,
    "10": 5,
    "11": 7,
    "12": 7,
    "13": 7,
    "14": 6,
    "15": 7,
    "16": 4,
    "17": 4,
    "18": 4,
    "19": 4,
    "20": 4,
    "21": 3,
    "22": 3,
    "23": 3,
    "24": 3,
    "25": 3,
    "26": 2,
    "27": 2,
    "28": 2,
    "29": 2,
    "30": 2,
    "31": 2,
    "32": 2,
    "33": 2,
    "34": 3,
    "35": 3,
    "36": 1,
    "37": 1,
    "38": 3,
    "39": 1,
    "40": 7,
    "41": 7,
    "42": 4,
    "43": 0,
    "44": 7,
    "45": 0,
    "46": 0,
    "47": 0,
    "48": 0,
    "49": 0,
    "50": 5,
    "51": 5,
    "52": 5,
    "53": 5,
    "54": 5,
    "55": 6,
    "56": 1,
    "57": 1,
    "58": 1,
    "59": 1,
    "60": 1
}