{
    "1": 7,
    "2": 7,
    "3": 7,
    "4": 6,
    "5": 6,
    "6": 6,
    "7": 6,
    "8": 6,
    "9": 6,
    "10": 6,
    "11": 6,
    "12": 6,
    "13": 5,
    "14": 4,
    "15": 6,
    "16": 5,
    "17": 5,
    "18": 4,
    "19": 3,
    "20": 3,
    "21": 4,
    "22": 4,
    "23": 3,
    "24": 4,
    "25": 4,
    "26": 3,
    "27": 2,
    "28": 4,
    "29": 2,
    "30": 2,
    "31": 2,
    "32": 2,
    "33": 1,
    "34": 0,
    "35": 2,
    "36": 3,
    "37": 0,
    "38": 2,
    "39": 5,
    "40": 0,
    "41": 0,
    "42": 5,
    "43": 0,
    "44": 0,
    "45": 1,
    "46": 1,
    "47": 0,
    "48": 1,
    "49": 1,
    "50": 1,
    "51": 1,
    "52": 7,
    "53": 7,
    "54": 7
}