{
    "1": 5,
    "2": 4,
    "3": 4,
    "4": 3,
    "5": 2,
    "6": 1,
    "7": 0,
    "8": 3,
    "9": 2,
    "10": 0,
    "11": 1,
    "12": 3,
    "13": 4,
    "14": 1,
    "15": 4,
    "16": 3,
    "17": 4,
    "18": 5,
    "19": 0,
    "20": 2,
    "21": 1,
    "22": 1,
    "23": 5,
    "24": 4,
    "25": 0,
    "26": 0,
    "27": 3,
    "28": 1,
    "29": 1,
    "30": 2,
    "31": 2,
    "32": 3,
    "33": 2,
    "34": 1,
    "35": 5,
    "36": 5,
    "37": 5,
    "38": 4,
    "39": 3,
    "40": 1,
    "41": 0,
    "42": 3,
    "43": 5,
    "44": 3,
    "45": 0,
    "46": 0,
    "47": 2,
    "48": 5,
    "49": 2,
    "50": 5,
    "51": 4,
    "52": 4,
    "53": 2
}