{
    "1": 7,
    "2": 6,
    "3": 6,
    "4": 5,
    "5": 5,
    "6": 4,
    "7": 3,
    "8": 5,
    "9": 5,
    "10": 2,
    "11": 5,
    "12": 1,
    "13": 0,
    "14": 1,
    "15": 4,
    "16": 1,
    "17": 2,
    "18": 6,
    "19": 0,
    "20": 0,
    "21": 6,
    "22": 4,
    "23": 1,
    "24": 6,
    "25": 2,
    "26": 6,
    "27": 1,
    "28": 0,
    "29": 4,
    "30": 2,
    "31": 7,
    "32": 7,
    "33": 4,
    "34": 1,
    "35": 7,
    "36": 3,
    "37": 4,
    "38": 0,
    "39": 0,
    "40": 3,
    "41": 0,
    "42": 2,
    "43": 1,
    "44": 2,
    "45": 7,
    "46": 4,
    "47": 7,
    "48": 5,
    "49": 2,
    "50": 3,
    "51": 3,
    "52": 6,
    "53": 7,
    "54": 3
}