{
    "1": 7,
    "2": 7,
    "3": 6,
    "4": 5,
    "5": 4,
    "6": 3,
    "7": 5,
    "8": 2,
    "9": 2,
    "10": 5,
    "11": 3,
    "12": 3,
    "13": 4,
    "14": 3,
    "15": 7,
    "16": 1,
    "17": 6,
    "18": 6,
    "19": 4,
    "20": 2,
    "21": 3,
    "22": 2,
    "23": 5,
    "24": 1,
    "25": 0,
    "26": 0,
    "27": 1,
    "28": 5,
    "29": 6,
    "30": 4,
    "31": 2,
    "32": 1,
    "33": 0,
    "34": 4,
    "35": 0,
    "36": 5,
    "37": 5,
    "38": 1,
    "39": 1,
    "40": 7,
    "41": 3,
    "42": 7,
    "43": 4,
    "44": 7,
    "45": 2,
    "46": 1,
    "47": 5,
    "48": 0,
    "49": 6,
    "50": 0,
    "51": 6,
    "52": 0,
    "53": 6,
    "54": 4,
    "55": 7,
    "56": 3,
    "57": 4,
    "58": 3,
    "59": 2,
    "60": 7
}