{
    "1": 7,
    "2": 7,
    "3": 7,
    "4": 7,
    "5": 7,
    "6": 7,
    "7": 7,
    "8": 7,
    "9": 6,
    "10": 6,
    "11": 6,
    "12": 6,
    "13": 6,
    "14": 7,
    "15": 6,
    "16": 6,
    "17": 5,
    "18": 4,
    "19": 4,
    "20": 4,
    "21": 5,
    "22": 5,
    "23": 5,
    "24": 5,
    "25": 5,
    "26": 3,
    "27": 3,
    "28": 3,
    "29": 3,
    "30": 3,
    "31": 3,
    "32": 2,
    "33": 2,
    "34": 5,
    "35": 5,
    "36": 2,
    "37": 2,
    "38": 5,
    "39": 2,
    "40": 6,
    "41": 6,
    "42": 7,
    "43": 7,
    "44": 6,
    "45": 1,
    "46": 1,
    "47": 1,
    "48": 1,
    "49": 1,
    "50": 1,
    "51": 1,
    "52": 1,
    "53": 1,
    "54": 4,
    "55": 4,
    "56": 0,
    "57": 0,
    "58": 0,
    "59": 0,
    "60": 0
}