{
    "1": 5,
    "2": 4,
    "3": 4,
    "4": 3,
    "5": 3,
    "6": 3,
    "7": 3,
    "8": 3,
    "9": 3,
    "10": 3,
    "11": 3,
    "12": 3,
    "13": 4,
    "14": 4,
    "15": 4,
    "16": 2,
    "17": 2,
    "18": 2,
    "19": 2,
    "20": 2,
    "21": 5,
    "22": 4,
    "23": 4,
    "24": 5,
    "25": 3,
    "26": 3,
    "27": 5,
    "28": 4,
    "29": 4,
    "30": 5,
    "31": 2,
    "32": 2,
    "33": 1,
    "34": 1,
    "35": 1,
    "36": 1,
    "37": 1,
    "38": 1,
    "39": 1,
    "40": 0,
    "41": 0,
    "42": 1,
    "43": 0,
    "44": 0,
    "45": 1,
    "46": 0,
    "47": 0,
    "48": 1,
    "49": 0,
    "50": 0,
    "51": 1,
    "52": 1,
    "53": 5
}