{
    "1": 7,
    "2": 7,
    "3": 7,
    "4": 7,
    "5": 7,
    "6": 7,
    "7": 7,
    "8": 7,
    "9": 6,
    "10": 5,
    "11": 4,
    "12": 3,
    "13": 6,
    "14": 6,
    "15": 6,
    "16": 6,
    "17": 2,
    "18": 2,
    "19": 2,
    "20": 2,
    "21": 2,
    "22": 2,
    "23": 1,
    "24": 1,
    "25": 1,
    "26": 1,
    "27": 4,
    "28": 4,
    "29": 4,
    "30": 4,
    "31": 4,
    "32": 4,
    "33": 4,
    "34": 1,
    "35": 1,
    "36": 0,
    "37": 0,
    "38": 1,
    "39": 0,
    "40": 6,
    "41": 6,
    "42": 2,
    "43": 0,
    "44": 6,
    "45": 0,
    "46": 0,
    "47": 0,
    "48": 0,
    "49": 3,
    "50": 3,
    "51": 3,
    "52": 3,
    "53": 3,
    "54": 3,
    "55": 3,
    "56": 5,
    "57": 5,
    "58": 5,
    "59": 5,
    "60": 5
}