{
    "1": 7,
    "2": 6,
    "3": 6,
    "4": 7,
    "5": 7,
    "6": 7,
    "7": 7,
    "8": 7,
    "9": 7,
    "10": 7,
    "11": 7,
    "12": 7,
    "13": 5,
    "14": 4,
    "15": 7,
    "16": 3,
    "17": 3,
    "18": 4,
    "19": 4,
    "20": 3,
    "21": 4,
    "22": 4,
    "23": 2,
    "24": 4,
    "25": 4,
    "26": 6,
    "27": 1,
    "28": 4,
    "29": 3,
    "30": 3,
    "31": 1,
    "32": 5,
    "33": 5,
    "34": 1,
    "35": 5,
    "36": 5,
    "37": 1,
    "38": 1,
    "39": 2,
    "40": 1,
    "41": 1,
    "42": 6,
    "43": 1,
    "44": 1,
    "45": 6,
    "46": 0,
    "47": 1,
    "48": 0,
    "49": 0,
    "50": 0,
    "51": 0,
    "52": 2,
    "53": 2,
    "54": 2
}