{
    "1": 5,
    "2": 5,
    "3": 5,
    "4": 5,
    "5": 5,
    "6": 5,
    "7": 5,
    "8": 5,
    "9": 5,
    "10": 5,
    "11": 5,
    "12": 5,
    "13": 4,
    "14": 4,
    "15": 4,
    "16": 4,
    "17": 4,
    "18": 4,
    "19": 3,
    "20": 3,
    "21": 3,
    "22": 2,
    "23": 2,
    "24": 2,
    "25": 2,
    "26": 2,
    "27": 2,
    "28": 3,
    "29": 3,
    "30": 3,
    "31": 1,
    "32": 1,
    "33": 1,
    "34": 0,
    "35": 0,
    "36": 0,
    "37": 1,
    "38": 1,
    "39": 1,
    "40": 1,
    "41": 1,
    "42": 1,
    "43": 0,
    "44": 0,
    "45": 0,
    "46": 1,
    "47": 1,
    "48": 1,
    "49": 0,
    "50": 0,
    "51": 0,
    "52": 0,
    "53": 0
}