{
    "1": 7,
    "2": 6,
    "3": 6,
    "4": 5,
    "5": 5,
    "6": 5,
    "7": 5,
    "8": 5,
    "9": 5,
    "10": 5,
    "11": 5,
    "12": 5,
    "13": 5,
    "14": 7,
    "15": 5,
    "16": 6,
    "17": 6,
    "18": 7,
    "19": 4,
    "20": 4,
    "21": 7,
    "22": 7,
    "23": 6,
    "24": 7,
    "25": 7,
    "26": 4,
    "27": 3,
    "28": 7,
    "29": 3,
    "30": 3,
    "31": 3,
    "32": 3,
    "33": 2,
    "34": 1,
    "35": 3,
    "36": 4,
    "37": 1,
    "38": 3,
    "39": 2,
    "40": 1,
    "41": 1,
    "42": 4,
    "43": 1,
    "44": 1,
    "45": 0,
    "46": 0,
    "47": 1,
    "48": 0,
    "49": 0,
    "50": 0,
    "51": 0,
    "52": 2,
    "53": 2,
    "54": 2
}