{
    "1": 7,
    "2": 7,
    "3": 7,
    "4": 7,
    "5": 7,
    "6": 7,
    "7": 7,
    "8": 7,
    "9": 7,
    "10": 7,
    "11": 7,
    "12": 6,
    "13": 5,
    "14": 5,
    "15": 5,
    "16": 5,
    "17": 4,
    "18": 4,
    "19": 4,
    "20": 4,
    "21": 4,
    "22": 4,
    "23": 4,
    "24": 5,
    "25": 3,
    "26": 6,
    "27": 6,
    "28": 6,
    "29": 6,
    "30": 6,
    "31": 6,
    "32": 2,
    "33": 2,
    "34": 3,
    "35": 3,
    "36": 3,
    "37": 3,
    "38": 3,
    "39": 3,
    "40": 5,
    "41": 5,
    "42": 4,
    "43": 2,
    "44": 5,
    "45": 2,
    "46": 2,
    "47": 2,
    "48": 2,
    "49": 1,
    "50": 1,
    "51": 1,
    "52": 1,
    "53": 1,
    "54": 1,
    "55": 1,
    "56": 0,
    "57": 0,
    "58": 0,
    "59": 0,
    "60": 0
}