{
    "1": 5,
    "2": 4,
    "3": 3,
    "4": 2,
    "5": 1,
    "6": 0,
    "7": 2,
    "8": 4,
    "9": 3,
    "10": 4,
    "11": 4,
    "12": 5,
    "13": 4,
    "14": 2,
    "15": 1,
    "16": 2,
    "17": 0,
    "18": 5,
    "19": 5,
    "20": 1,
    "21": 3,
    "22": 0,
    "23": 3,
    "24": 0,
    "25": 1,
    "26": 1,
    "27": 1,
    "28": 3,
    "29": 3,
    "30": 3,
    "31": 2,
    "32": 0,
    "33": 5,
    "34": 0,
    "35": 2,
    "36": 2,
    "37": 2,
    "38": 5,
    "39": 4,
    "40": 5,
    "41": 1,
    "42": 3,
    "43": 1,
    "44": 4,
    "45": 1,
    "46": 3,
    "47": 0,
    "48": 0,
    "49": 4,
    "50": 2,
    "51": 5,
    "52": 0,
    "53": 4
}