{
    "1": 7,
    "2": 6,
    "3": 6,
    "4": 5,
    "5": 5,
    "6": 4,
    "7": 3,
    "8": 7,
    "9": 5,
    "10": 2,
    "11": 7,
    "12": 1,
    "13": 0,
    "14": 1,
    "15": 4,
    "16": 6,
    "17": 0,
    "18": 3,
    "19": 0,
    "20": 0,
    "21": 0,
    "22": 0,
    "23": 3,
    "24": 1,
    "25": 7,
    "26": 2,
    "27": 1,
    "28": 6,
    "29": 0,
    "30": 4,
    "31": 7,
    "32": 7,
    "33": 1,
    "34": 1,
    "35": 3,
    "36": 2,
    "37": 1,
    "38": 3,
    "39": 3,
    "40": 4,
    "41": 5,
    "42": 5,
    "43": 6,
    "44": 6,
    "45": 5,
    "46": 3,
    "47": 4,
    "48": 6,
    "49": 2,
    "50": 4,
    "51": 2,
    "52": 7,
    "53": 2,
    "54": 2
}