{
    "1": 7,
    "2": 7,
    "3": 6,
    "4": 6,
    "5": 5,
    "6": 4,
    "7": 6,
    "8": 6,
    "9": 3,
    "10": 7,
    "11": 4,
    "12": 2,
    "13": 2,
    "14": 4,
    "15": 4,
    "16": 4,
    "17": 7,
    "18": 5,
    "19": 5,
    "20": 3,
    "21": 2,
    "22": 5,
    "23": 7,
    "24": 1,
    "25": 5,
    "26": 6,
    "27": 6,
    "28": 0,
    "29": 2,
    "30": 5,
    "31": 5,
    "32": 2,
    "33": 1,
    "34": 4,
    "35": 1,
    "36": 7,
    "37": 3,
    "38": 1,
    "39": 1,
    "40": 0,
    "41": 0,
    "42": 2,
    "43": 4,
    "44": 6,
    "45": 3,
    "46": 1,
    "47": 3,
    "48": 7,
    "49": 2,
    "50": 7,
    "51": 3,
    "52": 3,
    "53": 1,
    "54": 0,
    "55": 6,
    "56": 0,
    "57": 2,
    "58": 0,
    "59": 4,
    "60": 0
}