{
    "1": 5,
    "2": 5,
    "3": 5,
    "4": 4,
    "5": 4,
    "6": 4,
    "7": 4,
    "8": 4,
    "9": 4,
    "10": 4,
    "11": 4,
    "12": 4,
    "13": 3,
    "14": 3,
    "15": 3,
    "16": 3,
    "17": 3,
    "18": 3,
    "19": 3,
    "20": 3,
    "21": 5,
    "22": 2,
    "23": 2,
    "24": 2,
    "25": 1,
    "26": 1,
    "27": 1,
    "28": 2,
    "29": 2,
    "30": 2,
    "31": 1,
    "32": 1,
    "33": 1,
    "34": 0,
    "35": 0,
    "36": 0,
    "37": 0,
    "38": 0,
    "39": 0,
    "40": 0,
    "41": 0,
    "42": 1,
    "43": 4,
    "44": 4,
    "45": 4,
    "46": 2,
    "47": 2,
    "48": 2,
    "49": 1,
    "50": 1,
    "51": 5,
    "52": 3,
    "53": 5
}