{
    "1": 5,
    "2": 4,
    "3": 4,
    "4": 3,
    "5": 3,
    "6": 3,
    "7": 2,
    "8": 2,
    "9": 2,
    "10": 2,
    "11": 2,
    "12": 2,
    "13": 4,
    "14": 4,
    "15": 4,
    "16": 4,
    "17": 4,
    "18": 4,
    "19": 1,
    "20": 1,
    "21": 5,
    "22": 1,
    "23": 1,
    "24": 1,
    "25": 1,
    "26": 1,
    "27": 3,
    "28": 3,
    "29": 3,
    "30": 3,
    "31": 2,
    "32": 2,
    "33": 2,
    "34": 5,
    "35": 5,
    "36": 5,
    "37": 0,
    "38": 0,
    "39": 0,
    "40": 1,
    "41": 1,
    "42": 3,
    "43": 0,
    "44": 0,
    "45": 3,
    "46": 0,
    "47": 0,
    "48": 4,
    "49": 0,
    "50": 0,
    "51": 5,
    "52": 5,
    "53": 5
}