{
    "1": 7,
    "2": 7,
    "3": 6,
    "4": 5,
    "5": 5,
    "6": 4,
    "7": 6,
    "8": 6,
    "9": 3,
    "10": 2,
    "11": 2,
    "12": 3,
    "13": 3,
    "14": 6,
    "15": 3,
    "16": 3,
    "17": 7,
    "18": 7,
    "19": 7,
    "20": 7,
    "21": 5,
    "22": 7,
    "23": 7,
    "24": 5,
    "25": 5,
    "26": 4,
    "27": 4,
    "28": 4,
    "29": 4,
    "30": 4,
    "31": 4,
    "32": 1,
    "33": 1,
    "34": 5,
    "35": 5,
    "36": 1,
    "37": 1,
    "38": 5,
    "39": 1,
    "40": 3,
    "41": 3,
    "42": 0,
    "43": 0,
    "44": 3,
    "45": 0,
    "46": 0,
    "47": 0,
    "48": 0,
    "49": 0,
    "50": 2,
    "51": 0,
    "52": 2,
    "53": 2,
    "54": 2,
    "55": 6,
    "56": 6,
    "57": 6,
    "58": 2,
    "59": 2,
    "60": 6
}