{
    "1": 5,
    "2": 4,
    "3": 4,
    "4": 4,
    "5": 4,
    "6": 4,
    "7": 3,
    "8": 3,
    "9": 3,
    "10": 3,
    "11": 3,
    "12": 3,
    "13": 2,
    "14": 2,
    "15": 2,
    "16": 3,
    "17": 3,
    "18": 3,
    "19": 3,
    "20": 3,
    "21": 5,
    "22": 1,
    "23": 1,
    "24": 1,
    "25": 1,
    "26": 1,
    "27": 1,
    "28": 1,
    "29": 1,
    "30": 1,
    "31": 1,
    "32": 1,
    "33": 0,
    "34": 0,
    "35": 0,
    "36": 0,
    "37": 5,
    "38": 5,
    "39": 5,
    "40": 0,
    "41": 0,
    "42": 4,
    "43": 2,
    "44": 2,
    "45": 4,
    "46": 2,
    "47": 2,
    "48": 4,
    "49": 2,
    "50": 2,
    "51": 2,
    "52": 4,
    "53": 5
}