{
    "1": 7,
    "2": 7,
    "3": 7,
    "4": 6,
    "5": 6,
    "6": 5,
    "7": 5,
    "8": 6,
    "9": 6,
    "10": 6,
    "11": 6,
    "12": 6,
    "13": 4,
    "14": 3,
    "15": 6,
    "16": 3,
    "17": 2,
    "18": 3,
    "19": 3,
    "20": 5,
    "21": 3,
    "22": 3,
    "23": 4,
    "24": 3,
    "25": 3,
    "26": 3,
    "27": 1,
    "28": 3,
    "29": 2,
    "30": 2,
    "31": 1,
    "32": 5,
    "33": 5,
    "34": 1,
    "35": 4,
    "36": 4,
    "37": 1,
    "38": 1,
    "39": 2,
    "40": 1,
    "41": 1,
    "42": 4,
    "43": 1,
    "44": 1,
    "45": 2,
    "46": 0,
    "47": 1,
    "48": 0,
    "49": 0,
    "50": 0,
    "51": 0,
    "52": 7,
    "53": 7,
    "54": 7
}