{
    "1": 7,
    "2": 7,
    "3": 6,
    "4": 5,
    "5": 5,
    "6": 4,
    "7": 4,
    "8": 4,
    "9": 4,
    "10": 3,
    "11": 3,
    "12": 2,
    "13": 2,
    "14": 4,
    "15": 3,
    "16": 3,
    "17": 6,
    "18": 7,
    "19": 6,
    "20": 6,
    "21": 6,
    "22": 6,
    "23": 6,
    "24": 7,
    "25": 6,
    "26": 1,
    "27": 1,
    "28": 1,
    "29": 1,
    "30": 1,
    "31": 1,
    "32": 1,
    "33": 1,
    "34": 6,
    "35": 6,
    "36": 7,
    "37": 7,
    "38": 6,
    "39": 7,
    "40": 3,
    "41": 3,
    "42": 0,
    "43": 0,
    "44": 3,
    "45": 0,
    "46": 0,
    "47": 0,
    "48": 0,
    "49": 0,
    "50": 5,
    "51": 5,
    "52": 5,
    "53": 5,
    "54": 5,
    "55": 4,
    "56": 2,
    "57": 2,
    "58": 2,
    "59": 2,
    "60": 2
}