{
    "1": 7,
    "2": 7,
    "3": 6,
    "4": 6,
    "5": 6,
    "6": 7,
    "7": 6,
    "8": 6,
    "9": 6,
    "10": 5,
    "11": 4,
    "12": 7,
    "13": 3,
    "14": 6,
    "15": 4,
    "16": 4,
    "17": 2,
    "18": 2,
    "19": 2,
    "20": 2,
    "21": 2,
    "22": 2,
    "23": 1,
    "24": 1,
    "25": 1,
    "26": 1,
    "27": 5,
    "28": 5,
    "29": 5,
    "30": 5,
    "31": 5,
    "32": 5,
    "33": 5,
    "34": 1,
    "35": 1,
    "36": 7,
    "37": 7,
    "38": 1,
    "39": 7,
    "40": 4,
    "41": 4,
    "42": 2,
    "43": 0,
    "44": 4,
    "45": 0,
    "46": 0,
    "47": 0,
    "48": 4,
    "49": 4,
    "50": 0,
    "51": 0,
    "52": 0,
    "53": 0,
    "54": 3,
    "55": 3,
    "56": 3,
    "57": 3,
    "58": 3,
    "59": 3,
    "60": 3
}