{
    "1": 7,
    "2": 7,
    "3": 7,
    "4": 7,
    "5": 7,
    "6": 7,
    "7": 7,
    "8": 7,
    "9": 7,
    "10": 7,
    "11": 6,
    "12": 7,
    "13": 6,
    "14": 6,
    "15": 6,
    "16": 6,
    "17": 6,
    "18": 5,
    "19": 5,
    "20": 5,
    "21": 5,
    "22": 5,
    "23": 4,
    "24": 6,
    "25": 4,
    "26": 3,
    "27": 3,
    "28": 2,
    "29": 3,
    "30": 3,
    "31": 3,
    "32": 2,
    "33": 2,
    "34": 4,
    "35": 4,
    "36": 2,
    "37": 6,
    "38": 4,
    "39": 6,
    "40": 6,
    "41": 6,
    "42": 1,
    "43": 1,
    "44": 6,
    "45": 1,
    "46": 1,
    "47": 1,
    "48": 1,
    "49": 1,
    "50": 1,
    "51": 1,
    "52": 1,
    "53": 1,
    "54": 1,
    "55": 2,
    "56": 0,
    "57": 0,
    "58": 0,
    "59": 0,
    "60": 0
}