{
    "1": 7,
    "2": 6,
    "3": 6,
    "4": 7,
    "5": 7,
    "6": 7,
    "7": 7,
    "8": 7,
    "9": 7,
    "10": 7,
    "11": 7,
    "12": 7,
    "13": 6,
    "14": 5,
    "15": 7,
    "16": 4,
    "17": 4,
    "18": 5,
    "19": 5,
    "20": 4,
    "21": 5,
    "22": 5,
    "23": 4,
    "24": 5,
    "25": 5,
    "26": 3,
    "27": 2,
    "28": 5,
    "29": 1,
    "30": 1,
    "31": 2,
    "32": 3,
    "33": 3,
    "34": 2,
    "35": 6,
    "36": 6,
    "37": 2,
    "38": 2,
    "39": 4,
    "40": 2,
    "41": 2,
    "42": 3,
    "43": 2,
    "44": 2,
    "45": 3,
    "46": 0,
    "47": 2,
    "48": 0,
    "49": 0,
    "50": 0,
    "51": 0,
    "52": 1,
    "53": 1,
    "54": 1
}