{
    "1": 5,
    "2": 5,
    "3": 5,
    "4": 5,
    "5": 5,
    "6": 5,
    "7": 5,
    "8": 5,
    "9": 5,
    "10": 5,
    "11": 5,
    "12": 5,
    "13": 4,
    "14": 4,
    "15": 4,
    "16": 4,
    "17": 4,
    "18": 4,
    "19": 4,
    "20": 4,
    "21": 3,
    "22": 3,
    "23": 3,
    "24": 3,
    "25": 2,
    "26": 2,
    "27": 2,
    "28": 2,
    "29": 2,
    "30": 2,
    "31": 2,
    "32": 2,
    "33": 1,
    "34": 1,
    "35": 1,
    "36": 1,
    "37": 1,
    "38": 1,
    "39": 1,
    "40": 1,
    "41": 1,
    "42": 3,
    "43": 3,
    "44": 3,
    "45": 3,
    "46": 0,
    "47": 0,
    "48": 0,
    "49": 0,
    "50": 0,
    "51": 0,
    "52": 0,
    "53": 0
}