{
    "1": 7,
    "2": 7,
    "3": 6,
    "4": 6,
    "5": 6,
    "6": 7,
    "7": 6,
    "8": 6,
    "9": 5,
    "10": 5,
    "11": 5,
    "12": 5,
    "13": 5,
    "14": 6,
    "15": 5,
    "16": 5,
    "17": 7,
    "18": 7,
    "19": 7,
    "20": 7,
    "21": 7,
    "22": 7,
    "23": 7,
    "24": 5,
    "25": 4,
    "26": 3,
    "27": 3,
    "28": 3,
    "29": 3,
    "30": 3,
    "31": 3,
    "32": 6,
    "33": 6,
    "34": 4,
    "35": 4,
    "36": 4,
    "37": 4,
    "38": 4,
    "39": 4,
    "40": 5,
    "41": 5,
    "42": 2,
    "43": 2,
    "44": 5,
    "45": 2,
    "46": 2,
    "47": 2,
    "48": 2,
    "49": 1,
    "50": 1,
    "51": 1,
    "52": 1,
    "53": 1,
    "54": 1,
    "55": 1,
    "56": 0,
    "57": 0,
    "58": 0,
    "59": 0,
    "60": 0
}