{
    "1": 7,
    "2": 7,
    "3": 7,
    "4": 7,
    "5": 7,
    "6": 7,
    "7": 7,
    "8": 7,
    "9": 6,
    "10": 6,
    "11": 6,
    "12": 6,
    "13": 6,
    "14": 7,
    "15": 6,
    "16": 6,
    "17": 5,
    "18": 4,
    "19": 5,
    "20": 5,
    "21": 5,
    "22": 5,
    "23": 5,
    "24": 3,
    "25": 5,
    "26": 2,
    "27": 2,
    "28": 4,
    "29": 2,
    "30": 2,
    "31": 2,
    "32": 4,
    "33": 4,
    "34": 5,
    "35": 5,
    "36": 3,
    "37": 3,
    "38": 5,
    "39": 3,
    "40": 6,
    "41": 6,
    "42": 7,
    "43": 7,
    "44": 6,
    "45": 7,
    "46": 7,
    "47": 7,
    "48": 7,
    "49": 4,
    "50": 1,
    "51": 1,
    "52": 1,
    "53": 1,
    "54": 1,
    "55": 3,
    "56": 0,
    "57": 0,
    "58": 0,
    "59": 0,
    "60": 0
}