{
    "1": 7,
    "2": 6,
    "3": 6,
    "4": 7,
    "5": 7,
    "6": 7,
    "7": 7,
    "8": 7,
    "9": 7,
    "10": 7,
    "11": 7,
    "12": 7,
    "13": 6,
    "14": 5,
    "15": 7,
    "16": 4,
    "17": 4,
    "18": 5,
    "19": 5,
    "20": 3,
    "21": 5,
    "22": 5,
    "23": 3,
    "24": 5,
    "25": 5,
    "26": 2,
    "27": 1,
    "28": 5,
    "29": 6,
    "30": 6,
    "31": 1,
    "32": 2,
    "33": 2,
    "34": 1,
    "35": 2,
    "36": 2,
    "37": 1,
    "38": 1,
    "39": 4,
    "40": 1,
    "41": 1,
    "42": 4,
    "43": 1,
    "44": 1,
    "45": 4,
    "46": 0,
    "47": 1,
    "48": 0,
    "49": 0,
    "50": 0,
    "51": 0,
    "52": 3,
    "53": 3,
    "54": 3
}