{
    "1": 5,
    "2": 4,
    "3": 4,
    "4": 3,
    "5": 4,
    "6": 4,
    "7": 3,
    "8": 5,
    "9": 4,
    "10": 2,
    "11": 1,
    "12": 3,
    "13": 2,
    "14": 4,
    "15": 5,
    "16": 1,
    "17": 0,
    "18": 5,
    "19": 1,
    "20": 2,
    "21": 3,
    "22": 3,
    "23": 3,
    "24": 0,
    "25": 5,
    "26": 4,
    "27": 0,
    "28": 1,
    "29": 4,
    "30": 0,
    "31": 1,
    "32": 5,
    "33": 1,
    "34": 0,
    "35": 1,
    "36": 1,
    "37": 0,
    "38": 4,
    "39": 0,
    "40": 5,
    "41": 4,
    "42": 5,
    "43": 3,
    "44": 4,
    "45": 5,
    "46": 2,
    "47": 3,
    "48": 5,
    "49": 3,
    "50": 1,
    "51": 3,
    "52": 2,
    "53": 1
}