{
    "1": 7,
    "2": 6,
    "3": 5,
    "4": 7,
    "5": 7,
    "6": 6,
    "7": 4,
    "8": 7,
    "9": 3,
    "10": 2,
    "11": 7,
    "12": 1,
    "13": 0,
    "14": 0,
    "15": 5,
    "16": 0,
    "17": 3,
    "18": 2,
    "19": 1,
    "20": 2,
    "21": 1,
    "22": 6,
    "23": 1,
    "24": 2,
    "25": 4,
    "26": 2,
    "27": 0,
    "28": 0,
    "29": 4,
    "30": 0,
    "31": 3,
    "32": 2,
    "33": 1,
    "34": 2,
    "35": 5,
    "36": 3,
    "37": 6,
    "38": 3,
    "39": 4,
    "40": 0,
    "41": 4,
    "42": 4,
    "43": 5,
    "44": 6,
    "45": 1,
    "46": 6,
    "47": 3,
    "48": 5,
    "49": 5,
    "50": 5,
    "51": 6,
    "52": 3,
    "53": 4,
    "54": 1
}