{
    "1": 7,
    "2": 6,
    "3": 5,
    "4": 6,
    "5": 6,
    "6": 6,
    "7": 6,
    "8": 4,
    "9": 3,
    "10": 6,
    "11": 6,
    "12": 6,
    "13": 6,
    "14": 5,
    "15": 7,
    "16": 2,
    "17": 1,
    "18": 1,
    "19": 5,
    "20": 4,
    "21": 4,
    "22": 3,
    "23": 5,
    "24": 4,
    "25": 3,
    "26": 5,
    "27": 1,
    "28": 0,
    "29": 1,
    "30": 5,
    "31": 2,
    "32": 7,
    "33": 0,
    "34": 4,
    "35": 3,
    "36": 3,
    "37": 1,
    "38": 0,
    "39": 0,
    "40": 7,
    "41": 4,
    "42": 6,
    "43": 6,
    "44": 0,
    "45": 1,
    "46": 2,
    "47": 2,
    "48": 1,
    "49": 0,
    "50": 2,
    "51": 3,
    "52": 2,
    "53": 7,
    "54": 2,
    "55": 7,
    "56": 3,
    "57": 0,
    "58": 7,
    "59": 4,
    "60": 5
}