{
    "1": 7,
    "2": 7,
    "3": 7,
    "4": 6,
    "5": 6,
    "6": 6,
    "7": 6,
    "8": 6,
    "9": 6,
    "10": 6,
    "11": 6,
    "12": 6,
    "13": 5,
    "14": 4,
    "15": 6,
    "16": 3,
    "17": 3,
    "18": 4,
    "19": 4,
    "20": 7,
    "21": 4,
    "22": 4,
    "23": 2,
    "24": 4,
    "25": 4,
    "26": 3,
    "27": 1,
    "28": 4,
    "29": 3,
    "30": 3,
    "31": 1,
    "32": 7,
    "33": 7,
    "34": 1,
    "35": 5,
    "36": 5,
    "37": 1,
    "38": 1,
    "39": 5,
    "40": 1,
    "41": 1,
    "42": 5,
    "43": 1,
    "44": 1,
    "45": 2,
    "46": 0,
    "47": 1,
    "48": 0,
    "49": 0,
    "50": 0,
    "51": 0,
    "52": 2,
    "53": 2,
    "54": 2
}