{
    "1": 5,
    "2": 4,
    "3": 5,
    "4": 3,
    "5": 3,
    "6": 2,
    "7": 3,
    "8": 4,
    "9": 1,
    "10": 3,
    "11": 4,
    "12": 0,
    "13": 5,
    "14": 4,
    "15": 0,
    "16": 5,
    "17": 3,
    "18": 0,
    "19": 3,
    "20": 5,
    "21": 0,
    "22": 2,
    "23": 2,
    "24": 1,
    "25": 4,
    "26": 2,
    "27": 0,
    "28": 5,
    "29": 2,
    "30": 0,
    "31": 2,
    "32": 3,
    "33": 0,
    "34": 1,
    "35": 2,
    "36": 1,
    "37": 1,
    "38": 4,
    "39": 1,
    "40": 3,
    "41": 3,
    "42": 4,
    "43": 4,
    "44": 0,
    "45": 4,
    "46": 2,
    "47": 4,
    "48": 2,
    "49": 3,
    "50": 3,
    "51": 1,
    "52": 5,
    "53": 1
}