{
    "1": 7,
    "2": 6,
    "3": 7,
    "4": 7,
    "5": 7,
    "6": 7,
    "7": 5,
    "8": 4,
    "9": 7,
    "10": 7,
    "11": 7,
    "12": 3,
    "13": 2,
    "14": 5,
    "15": 5,
    "16": 5,
    "17": 4,
    "18": 2,
    "19": 4,
    "20": 1,
    "21": 5,
    "22": 2,
    "23": 0,
    "24": 6,
    "25": 3,
    "26": 5,
    "27": 3,
    "28": 3,
    "29": 0,
    "30": 2,
    "31": 0,
    "32": 6,
    "33": 2,
    "34": 4,
    "35": 0,
    "36": 3,
    "37": 1,
    "38": 0,
    "39": 6,
    "40": 3,
    "41": 4,
    "42": 0,
    "43": 4,
    "44": 3,
    "45": 2,
    "46": 0,
    "47": 1,
    "48": 6,
    "49": 4,
    "50": 2,
    "51": 1,
    "52": 6,
    "53": 0,
    "54": 6,
    "55": 5,
    "56": 5,
    "57": 4,
    "58": 1,
    "59": 2,
    "60": 3
}