{
    "1": 7,
    "2": 7,
    "3": 7,
    "4": 6,
    "5": 6,
    "6": 6,
    "7": 6,
    "8": 6,
    "9": 6,
    "10": 6,
    "11": 6,
    "12": 6,
    "13": 7,
    "14": 5,
    "15": 6,
    "16": 5,
    "17": 4,
    "18": 5,
    "19": 5,
    "20": 3,
    "21": 5,
    "22": 5,
    "23": 2,
    "24": 5,
    "25": 5,
    "26": 3,
    "27": 4,
    "28": 5,
    "29": 4,
    "30": 3,
    "31": 1,
    "32": 4,
    "33": 7,
    "34": 1,
    "35": 4,
    "36": 2,
    "37": 1,
    "38": 1,
    "39": 3,
    "40": 1,
    "41": 1,
    "42": 7,
    "43": 1,
    "44": 1,
    "45": 3,
    "46": 0,
    "47": 1,
    "48": 0,
    "49": 0,
    "50": 0,
    "51": 0,
    "52": 2,
    "53": 2,
    "54": 2
}