{
    "1": 7,
    "2": 7,
    "3": 7,
    "4": 7,
    "5": 7,
    "6": 7,
    "7": 7,
    "8": 7,
    "9": 6,
    "10": 6,
    "11": 6,
    "12": 6,
    "13": 6,
    "14": 7,
    "15": 6,
    "16": 6,
    "17": 5,
    "18": 5,
    "19": 5,
    "20": 5,
    "21": 5,
    "22": 5,
    "23": 4,
    "24": 4,
    "25": 4,
    "26": 3,
    "27": 3,
    "28": 3,
    "29": 3,
    "30": 3,
    "31": 3,
    "32": 2,
    "33": 2,
    "34": 4,
    "35": 4,
    "36": 7,
    "37": 7,
    "38": 4,
    "39": 7,
    "40": 6,
    "41": 6,
    "42": 6,
    "43": 1,
    "44": 6,
    "45": 1,
    "46": 1,
    "47": 1,
    "48": 1,
    "49": 1,
    "50": 0,
    "51": 1,
    "52": 0,
    "53": 0,
    "54": 0,
    "55": 0,
    "56": 0,
    "57": 2,
    "58": 2,
    "59": 2,
    "60": 2
}