{
    "1": 7,
    "2": 7,
    "3": 7,
    "4": 6,
    "5": 7,
    "6": 7,
    "7": 7,
    "8": 7,
    "9": 5,
    "10": 5,
    "11": 5,
    "12": 5,
    "13": 5,
    "14": 7,
    "15": 5,
    "16": 5,
    "17": 4,
    "18": 4,
    "19": 4,
    "20": 4,
    "21": 4,
    "22": 4,
    "23": 4,
    "24": 5,
    "25": 3,
    "26": 6,
    "27": 6,
    "28": 6,
    "29": 6,
    "30": 6,
    "31": 6,
    "32": 2,
    "33": 2,
    "34": 3,
    "35": 3,
    "36": 3,
    "37": 3,
    "38": 3,
    "39": 3,
    "40": 5,
    "41": 5,
    "42": 1,
    "43": 1,
    "44": 5,
    "45": 1,
    "46": 1,
    "47": 1,
    "48": 1,
    "49": 0,
    "50": 0,
    "51": 0,
    "52": 0,
    "53": 0,
    "54": 0,
    "55": 0,
    "56": 2,
    "57": 2,
    "58": 2,
    "59": 2,
    "60": 2
}