{
    "1": 7,
    "2": 7,
    "3": 7,
    "4": 6,
    "5": 6,
    "6": 6,
    "7": 6,
    "8": 6,
    "9": 6,
    "10": 6,
    "11": 6,
    "12": 6,
    "13": 7,
    "14": 5,
    "15": 6,
    "16": 4,
    "17": 4,
    "18": 5,
    "19": 5,
    "20": 4,
    "21": 5,
    "22": 5,
    "23": 4,
    "24": 5,
    "25": 5,
    "26": 4,
    "27": 3,
    "28": 5,
    "29": 2,
    "30": 2,
    "31": 3,
    "32": 7,
    "33": 7,
    "34": 3,
    "35": 1,
    "36": 1,
    "37": 3,
    "38": 3,
    "39": 1,
    "40": 3,
    "41": 3,
    "42": 1,
    "43": 3,
    "44": 3,
    "45": 1,
    "46": 0,
    "47": 3,
    "48": 0,
    "49": 0,
    "50": 0,
    "51": 0,
    "52": 2,
    "53": 2,
    "54": 2
}